people	n. 人, 人民, 民族, 平民vt. 使住满人, 居住于
say	vt. 说, 讲, 念,说明, 指明vi. 说, 讲n. 意见, 发言权
make	vt. 制造, 安排,创造, 构成, 使得,产生, 造成, 整理,布置, 引起, 到达,进行vi. 开始, 前进,增大, 被制造, 被处理n. 制造, 构造, 性情
work	n. 工作, 劳动, 职业, 行为, 功, 作品, 成果, 产品, 工程vi. 工作, 劳动, 做, 运转, 起作用,被加工vt. 使工作, 使转动, 开动, 使用, 经营, 使逐渐变得,造成
one	n. 一(个)pron. 一, 任何人 num. 一, 一个a. 一致的, 完整的
food	n. 食物, 养料[医] 食物, 食品
time	n. 时间, 时侯, 时机, 时期, 期限, 次数, 节拍, 暂停,规定时间vt. 测定...的时间, 记录...的时间, 计时, 定时a. 时间的, 记时的, 定时的, 定期的, 分期的[计
student	n. 学生, 研究者,学者
many	n. 多数, 多数人a. 许多的 pron. 许多
find	vt. 发现, 感到,找到, 认为, 得到vi. 裁决n. 发现[计] 查找; DOS外部命令:在指定的文件或从键盘输入的文本行中寻找指定的字符串,将符合条件的行或行数输出到标准输出设备上
new	a. 新的, 陌生的,最近的, 不熟悉的 [法] 新发现的, 新的, 重新开始的
woman	n. 女人, 妇女, 女仆a. 女用的, 女性的, 妇女的vt. 贬称...为女人, 使成女人腔
get	vt. 得到, 获得,变成, 使得, 收获,接通, 抓住, 染上vi. 到达, 成为,变得n. (网球等)救球,生殖, 幼兽[计] 取得指令, 获取文件
life	n. 生活, 生命, 人生, 世事, 生物, 寿命, 一生, 生命力, 灵魂, 无期徒刑[医] 生活, 生存,生命, 寿命
year	n. 年, 年度, 年龄 [经] 年度
take	vt. 拿, 取, 抓,带领, 获得, 就座,接受, 吃, 吸引,采取, 乘, 需要,花费vi. 吃掉对方棋子,抓住, 起作用, 依法获得财产n. 拿, 取, 收成,奏效
use	n. 使用, 习惯, 使用价值, 用法, 使用权vt. 使用, 利用,运用, 耗费vi. 惯常
learn	vt. 学习；认识到；得知
may	n. 五月aux. 愿能, 可以,愿意
like	a. 相似的, 同样的 vt. 喜欢, 愿意, 想vi. 喜欢, 希望n. 爱好, 同样的人 (或物)prep. 象, 如同 adv. 可能
good	n. 善行, 好处, 利益a. 好的, 优良的,上等的, 愉快的,有益的, 好心的,慈善的, 虔诚的
way	n. 路, 路线, 路 途, 方法, 道路, 情形, 规模, 习惯,行业, 方面adv. 远远地, 非常
well	n. 井, 泉水, 源泉, 好v. 涌出a. 健康的, 良好的, 适宜的, 恰当的adv. 很好地, 适当地, 好意地, 很, 完全interj. 好啦
go	vi. 去, 走, 达到,运转, 查阅, 消失,结束, 放弃, 花费,流传, 趋于, 打算,剩下vt. 以...打赌, 对付, 忍受, 出产, 为被捕者出(保释 金)n. 去, 尝试, 进行
would	aux. 将, 愿意
child	n. 孩子, 产物, 追随者[医] 儿童
help	n. 帮忙, 帮助者,补救办法, 有益的东西vt. 帮助, 帮忙,接济, 治疗, 款待vi. 有用, 救命,招待[计] 帮助, 帮助程序; DOS外部命令: DOS命令的电子文件帮助程序
study	n. 学习, 研究, 学科, 论文, 求学, 书房, 试作vt. 学习, 读书,研究, 考虑, 计划vi. 学习, 思索
man	n. 男人, 人类, 人 vt. 为...配备人 手, 操纵, 使振奋 [计] 城域网, 手册
change	n. 变化, 找回的零钱, 找头, 更换 vt. 改变, 更换, 兑换
live	a. 活的, 生动的,精力充沛的, 实况转播的vi. 活, 生存, 居住vt. 过着, 度过,经历adv. 实况地
school	n. 学校, 鱼群, 门派, 学派vt. 教育, 训练,培养vi. 成群地游
think	vt. 想, 考虑, 想起, 想像, 打算,认为vi. 思考, 料想n. 想法a. 思想的
much	n. 大量, 许多, 重要的事a. 很多的, 重要的 adv. 多, 甚, 几乎
high	n. 高度, 高处a. 高的, 高级的,主要的, 高尚的, 高原的, 高音的, 昂贵的, 傲慢的 adv. 高度地, 奢侈地
need	n. 需要, 必须, 缺乏vt. 需要, 必需vi. 贫困, 有必要 aux. 需要
long	a. 长的, 长久的,冗长的, 做多头的vi. 渴望, 热望,极想adv. 长久, 始终n. 长时间, 长信号, 长整型[计] 长, 长整型
job	n. 工作, 零活, 职业, 事情vi. 做零工, 打杂,做股票经纪, 假公济私vt. 代客买卖, 批发, 承包, 欺骗[计] 作业
give	n. 弹性, 适应性 vt. 给, 授予, 供给, 产生, 发表,付出, 献出, 让出vi. 捐赠, 支持不住, 让步
see	vt. 看见, 查看,参观, 游览, 理解,知道, 同意vi. 看, 观看, 注意, 知道, 考虑n. 主教的职位
home	n. 家, 避难所, 故乡a. 家庭的, 国内的, 打中目标的 adv. 在家, 在本国, 打中目标地 [计] 返回始位
young	a. 年轻的, 无经验的, 朝气蓬勃的n. 青年们, 幼小动物, 崽
become	vi. 变成, 变得 vt. 适合
eat	v. 吃, 腐蚀
also	adv. 也, 并且, 同样地
even	a. 平坦的, 相等的, 连贯的, 均等的, 公平的, 偶数的, 平均的, 平衡的, 恰好的vt. 使平坦, 使相等vi. 变平, 成为相等adv. 甚至, 实际上, 完全, 十分n. 偶数,
world	n. 世界, 地球, 宇宙, 万物, 世人, 人间, 领域, 世事,世故, 社会生活, 大量[法] 世界, 地球,世人
know	v. 知道, 了解, 认识, 确信
can	vt. 装罐n. 罐头, 容器 aux. 能, 可以 [计] 作废字符
company	n. 公司, 友伴, 交往, 连队, 朋友, 一群vt. 陪伴vi. 交往
author	n. 作家, 作家的著作, 创始人[法] 作者, 著作人, 本人
education	n. 教育, 训练, 教育学[医] 教育, 训练
come	vi. 过来, 来, 到达, 出现, 开始 interj. 喂
college	n. 学院, 大学, 学会
thing	n. 事物, 东西, 物, 用品, 事, 事件, 情况, 行为,特征
old	n. 以前, 往昔a. 老的, 旧的, 古老的, 年长的, 老练的
want	n. 需要的东西, 缺乏, 贫困, 需要 vt. 要, 希望, 应该, 缺少vi. 生活困苦, 需要, 缺少
age	n. 年龄, 老年, 成年, 寿命, 时代, 时期v. 变老, 成熟
business	n. 生意, 事情, 业务, 商业, 商行, 职责[经] 企业, 商业,营业
family	n. 家庭, 家人, 族a. 家庭的
parent	n. 父母, 父母亲,根源[法] 父亲, 母亲,根源
feel	vt. 感觉, 觉得,触摸, 以为vi. 有知觉, 摸索,同情n. 感觉, 觉得, 触摸
look	n. 一看, 神色, 样子, 面容vi. 看, 注意, 朝着, 显得vt. 打量, 看上去与...一样, 以眼色(或脸色)显示, 期待
first	adv. 首先, 第一,优先a. 第一的 num. 第一n. 开始, 第一
research	n. 研究, 调查, 考察vi. 研究, 调查
show	n. 显示, 表现, 展览, 卖弄, 炫耀, 外观, 演出, 洋相 vt. 表示, 显示, 展现, 陈列, 演出,表明, 指出, 带领vi. 露面, 显现,演出[计] 显示
two	num. 二, 二个
pay	n. 薪资, 付款, 补偿vt. 支付, 付清, 补偿, 偿还, 对...有利, 为...涂防水物vi. 付款, 付出代价, 偿还, 得到报应, 获得好处
start	n. 惊起, 出发, 开端, 起点, 吃惊, 有利条件vi. 开始, 出发, 启动, 跳起, 吃惊,出现, 松动, 脱落,起价, 参赛vt. 使惊起, 开动,发动, 启动, 开始,创办,
often	adv. 时常, 常常
country	n. 国家, 乡村, 地区, 故乡a. 乡下的, 农村的 [计] DOS外部命令:用于设定国家代码,包括日期时间及货币格式
increase	n. 增加, 增进, 利益vt. 增加, 加大vi. 增加, 繁殖
try	n. 尝试, 试验, 审理, 审判vt. 试, 尝试, 试验, 考验, 审问,提炼vi. 尝试, 试图
likely	a. 有可能的, 合适的, 前途有望的 adv. 或许, 可能
problem	n. 问题, 难题a. 成问题的, 难处理的
car	n. 汽车, 客车 [机] 车
book	n. 书, 书籍, 帐簿, 名册, 工作簿v. 登记, 预订[计] 工作簿
human	n. 人, 人类a. 人类的, 似人类的, 人性的, 有同情心的
different	a. 不同的[机] 差动, 微分的, 差速器
system	n. 系统, 体系, 制度, 方式, 秩序, 分类原则[计] 系统; 体制;体系
technology	n. 技术, 工业技术, 术语[医] 技术学, 工艺学
write	vt. 书写, 著述,写, 写满, 写信给vi. 写, 写字, 写信, 写作, 作曲[计] 书写器
still	n. 蒸馏室, 寂静,剧照v. 蒸馏, (使)平静, (使)静止a. 静止的, 不动 的, 静寂的, 不起泡的, 静物摄影的 adv. 仍然, 更, 静止地conj. 然而, 但是
report	n. 报告, 报道, 传说, 案情报告, 爆炸声, 成绩单vt. 报告, 汇报,转述, 报道, 揭发,使报到vi. 报告, 写报道,报到[计] 报告
day	n. 天, 日子, 白天, 工作日[医] 日(一昼夜),昼, 白天
health	n. 健康, 卫生, 蓬勃, 健康状态[医] 健康
might	n. 力量, 权力 aux. 可能, 也许
early	a. 早的, 早熟的 adv. 很早, 初
keep	n. 生计, 维持, 保持vt. 保持, 保存,遵守, 看守, 整理,维持, 履行, 经营,拘留, 记帐vi. 保持, 继续不断
place	n. 地方, 地点, 位置, 住所, 座位, 地位, 处境, 特权,空间, 余地, 职务,位vt. 放置, 寄予,认出, 评定, 任命vi. 名次列前
price	n. 价格, 代价, 价值vt. 定...的价格
share	n. 部分, 参与, 一份, 参股, 份额 vt. 均分, 分担, 分享, 分配, 共有vi. 分享[计] 共享; DOS外部命令:在网络或多工系统中提供文件共享文件锁定及检测磁盘更动和对超过3
mean	a. 低劣的, 卑贱的, 简陋的, 吝啬的, 惭愧的, 平均的, 中间的, 普通的vt. 意谓, 想要,意欲, 预定vi. 用意, 有意义n. 平均数, 中间,中庸
skill	n. 技术, 技巧, 技能, 熟练, 熟练工人[化] 技能
program	n. 节目, 节目单,程序, 纲要, 大纲,计划vt. 规划, 拟...计划vi. 安排节目, 编程序[计] 程序
late	a. 迟的, 晚的, 已故的adv. 很晚, 很迟,晚
government	n. 政府, 内阁[经] 政府, 政治,政体
big	a. 大的, 重要的 adv. 大量地
money	n. 金钱, 一笔款,财富, 货币, 金额 [经] 货币, 金钱,财产
teach	vt. 教, 讲授, 教导, 教育vi. 教书, 教学,可以教
interest	n. 兴趣, 嗜好, 利息, 利益, 爱好, 趣味, 势力vt. 使感兴趣,与...有关系
grow	vt. 种植, 使长满vi. 生长, 变成,发展
hard	a. 坚硬的, 硬的,难的, 艰苦的, 困难的, 坚固的, 猛烈的, 艰难的, 结实的, 确实的adv. 坚硬地, 努力地, 辛苦地, 接近地, 猛烈地, 牢固地
offer	n. 给予(物), 出价, 提议, 意图,报价vt. 提供, 出价,奉献, 试图, 使出现, 演出vi. 出现, 献祭,提议, 求婚
part	n. 部分, 局部, 零件, 要素, 等分, 职责, 角色, 部位 vt. 分开, 分离, 断绝, 区别, 分配vi. 分开, 断裂,分手a. 部分的, 局部的 adv. 部分地, 有些
spend	vt. 花费, 浪费,度过, 消耗, 消磨vi. 花费, 用尽
accord	n. 一致, 调和, 协定vt. 给与, 使一致vi. 相符合
experience	n. 经历, 经验, 体验vt. 经历, 经验,体验
improve	vt. 改良, 提高...的价值, 改善, 利用vi. 变得更好, 增加
small	a. 小的, 少的, 小型的, 低微的, 小气的, 细微的adv. 些微地n. 狭小部分
important	a. 重要的, 有地位的, 大量的, 显要的, 自负的[计] 要点
great	a. 大的, 非常的,主要的, 重大的, 崇高的, 伟大的 adv. 顺利地, 得意地n. 全部, 大人物,大师
teacher	n. 教师, 老师, 导师
buy	vt. 买, 获得vi. 买n. 购买, 买得的东西
computer	n. 电脑, 电子计算机[计] 计算机
care	n. 小心, 照料, 忧虑vi. 关心, 介意vt. 在意, 喜欢
public	n. 公众, 民众a. 公众的, 公共的, 公立的, 公用的
around	prep. 包围, 在...周围, 四处adv. 兜着圈子, 在附近, 到处
idea	n. 主意, 办法, 理想, 思想, 概念, 意见[医] 观念, 思想
information	n. 消息, 知识, 通知, 情报, 信息, 问讯处, 起诉[计] 信息
something	pron. 某事, 某物
leave	n. 许可, 告别, 请假, 休假vt. 离开, 剩下,遗忘, 委托, 丢弃vi. 出发, 离开,生叶
benefit	n. 利益 vt. 有益于vi. 受益
develop	vt. 发展, 使发达,进步, 洗印, 显影vi. 发展, 生长
memory	n. 记忆, 记忆力,回忆, 纪念, 存储n. 内存[计] 存储器, 内存, 查看内存实用程序
kid	n. 小山羊, 小山羊肉, 小孩, 欺骗a. 小山羊皮制的v. 哄骗, 嘲弄
numb	a. 麻木的, 失去知觉的vt. 使麻木, 使昏迷, 使失去知觉
turn	n. 转弯, 转动, 旋转, 翻转, 一圈, 顺次, 改动, 变化,性格, 特色, 形状,转折vt. 使旋转, 转弯,转动, 使转向, 驱赶, 阻挡, 兑换, 改写, 使作对, 绕过, 使流通
fall	n. 落下, 瀑布, 采伐量, 下降, 落差,降低, 堕落, 秋天vi. 倒下, 落下, 来临, 失守, 阵亡,下跌, 减弱, 倾斜,垮台, 轮到, 变成,降低a. 秋天的
ask	vi. 问, 要求vt. 问, 要求, 邀请, 需要
friend	n. 朋友, 支持者,赞助者[法] 朋友, 友人,赞助者
future	n. 未来, 将来a. 将来的, 未来的
whether	conj. 是否, 不论 pron. 两个中的哪一个
adult	n. 成人, 成虫a. 成年的, 成熟的
build	v. 建立, 建筑n. 构造, 体格
every	a. 每一, 所有的
cost	n. 代价, 价值, 费用vi. 花费vt. 使失去, 值,使花费
result	n. 结果, 成绩, 答案vi. 产生, 结果,致使[计] 结果
team	n. 队, 组vt. 把马(牛)套在同一辆车上, 把...编成一组vi. 驾驶卡车, 协作
large	a. 大的, 大量的,宽大的, 广博的 adv. 大大地, 夸大地
class	n. 班级, 阶级, 种类, 课vt. 分类[计] 类别; 类; 种类; 类程
we	pron. 我们
recent	a. 最近的, 近代的, 最新的[经] 最近的, 新进的
question	n. 问题, 询问v. 询问, 审问, 怀疑[计] 询问
provide	vt. 提供, 供应,规定, 预备vi. 作准备, 抚养,规定
call	n. 呼叫, 访问, 打电话, 号召, 召集,要求vt. 呼叫, 召集,打电话vi. 叫喊, 访问,叫牌[计] 调用; 呼叫; DOS内部命令:在批处理文件中调用另一个批处理文件
right	n. 权利, 右边, 正义, 右派, 公正a. 正确的, 对的,恰当的, 正常的,正直的, 正面的,右方的adv. 正确地, 以有利结果, 一直, 直接, 向右vt. 扶直, 整理,纠正
economy	n. 经济, 理财, 节约[医] 经济, 整体
lot	n. 运气, 签, 抽签, 份额, 许多,一堆vt. 划分vi. 抽签, 抓阄
create	vt. 创造, 建造,引起, 任命
brain	n. 脑vt. 打碎脑部
effect	n. 结果, 影响, 效果, 印象vt. 实行, 引起,完成[计] 效果
believe	v. 相信
cook	n. 厨子, 厨师 vt. 烹调, 煮饭,加热vi. 在煮着
group	n. 团体, 组, 团,群v. 聚合, 成群[计] 创建组; 组,用户组
value	n. 价值, 价格, 购买力, 评价, 估价,计算结果vt. 评价, 估价,重视[计] 计算结果
lead	n. 铅, 铅条, 领 导, 超前量, 领引,榜样, 主角, 导线 vt. 引导, 带领, 领导, 指挥, 致使,加铅于, 用铅包vi. 领导, 带头,导致, 用测深锤测深, 被铅覆盖a. 带
tell	vt. 告诉, 说, 吩咐, 断定, 知道vi. 讲述, 泄密,告发, 表明
back	a. 后面的vt. 使后退, 支持vi. 倒退, 背靠 adv. 向后地n. 背部, 后面
rise	n. 上升, 增加, 上涨, 高地, 升高, 出现vi. 升起, 起身, 起立, 上升, 上涨,增长, 高耸, 起义,浮现vt. 使飞起
social	a. 社会的, 群居的, 社交的n. 联欢会
begin	v. 开始[计] 开始
researcher	n. 研究人员
seem	vi. 象是, 似乎
little	n. 一点点, 少许,一会儿, 短时间a. 小的, 很少的,幼小的, 琐碎的,短暂的, 矮小的 adv. 很少, 稍微,完全不
online	[计] 联机
happen	vi. 发生, 发生,恰巧
put	vt. 放, 摆, 安置,移动, 发射, 投掷,写上, 表达, 使从事, 使受到, 驱使,赋予vi. 出发, 航行,发芽n. 掷, 股票出售权, 笨蛋a. 固定不动的 [计] 发送文件
other	a. 其他的, 另外的, 从前的pron. 其他的, 他人, 另外一个
cause	n. 原因, 目标  vt. 引起, 使产生,使遭受
letter	n. 信, 字母, 证书, 字面意义, 铅字, 学问, 出租人 vt. 写字母于,在...上刻字母, 用字母标明vi. 写印刷体字 [计] 字母
suggest	vt. 提议, 建议,促成, 暗示, 启发,使人想起[法] 建议, 提出,提议
understand	vt. 理解, 了解,领会, 听说, 懂vi. 懂得, 认为
another	a. 另外的, 再一的, 不同的pron. 又一个, 另一个, 类似的另一个
person	n. 人, 人身, 人称 [法] 人, 法人, 人身
course	n. 课程, 路线, 过程, 一道菜, 道路v. 追, (使)跑
among	prep. 在...之中
career	n. 事业, 生涯, 成功[法] 职业, 专业,履历
reason	n. 理由, 原因, 理智, 道理, 前提, 理性vt. 说服, 推论,辩论vi. 推论, 劝说,思考
product	n. 产品, 结果, 乘积[化] 生产物
last	a. 最后的, 末尾的, 最近的vi. 持续, 支持,维持vt. 使维持, 够...用adv. 最后, 后来n. 最后, 末尾, 鞋楦头
sleep	n. 睡眠, 静止, 昏迷, 麻木, 长眠, 冬眠vi. 睡觉, 睡眠,静止vt. 睡
state	n. 州, 状态, 情形, 国家, 政府,领土, 国务, 社会地位a. 国家的, 正式的, 礼仪用的, 州的vt. 说明, 陈述,规定[计] 状态
reduce	vt. 减少, 分解,降低, 使衰退,把...分解, 把...归纳vi. 减少, 减肥,缩小[计] 缩小
city	n. 城市, 市[法] 都市, 城市,市
include	vt. 包括, 把...算入, 包住[计] DOS内部命令:在CONFIG.SYS文件的一个配置块中包含另一配置块的内容
choose	vt. 选择, 宁愿,欲vi. 作出选择, 愿意[计] 选取
hand	n. 手, 爪, 指针,掌握, 协助, 人手,手艺, 手迹, 支配,插手vt. 交给, 支持,搀扶
market	n. 市场, 交易, 集市, 推销地区, 行情, 市面, 销路 vt. 在市场上交易,使上市, 销售vi. 在市场上买卖
possible	a. 可能的, 潜在的, 合适的n. 可能性, 可能的事物
since	prep. 自...以后,自...以来adv. 自那时以后 conj. 既然, 自...以后, 自...以来
must	n. 必须, 未发酵葡萄汁, 绝对必要的事物aux. 必须
form	n. 形状, 形体, 类型, 方式, 表格, 形式v. 形成, 排列, (使)组成n. 表单[计] 表单
service	n. 服务, 贡献, 雇佣, 公职, 服役, 功劳, 仪式, 送达,行政部门vt. 保养, 维修a. 武装部队的, 服务性的, 仆人的, 耐用的[计] 服务, 业务
today	n. 今天, 当今, 现在adv. 今天, 当今
example	n. 例子, 样本, 实例[化] 实例
art	n. 艺术, 人文科学, 技术, 巧妙,诡计, 美术[计] 实际保持时 间, 特许权和资源表, 平均检索时间,平均运行时间
easy	a. 容易的, 缓缓的, 舒适的, 从容的, 宽容的, 流畅的, 随便的, 自在的, 疲软的adv. 容易地, 慢慢地
rather	adv. 宁可, 稍微,相当
space	n. 位置, 空间, 距离, 太空, 空白, 间隔, (期刊等的)篇幅vt. 隔开, 分隔vi. 留间隔[计] 空白, 空格校验
paper	n. 纸, 文件, 文章, 报纸, 证券,证件vt. 用纸糊, 贴壁纸于, 用纸包装vi. 贴壁纸a. 纸做的, 纸上的
meal	n. 一餐, 膳食, 粗粉vi. 进餐
passage	n. 通道, 通过, 移居, 航行, 一段, 走廊vi. 通过, 经过,航行, 横渡, 争吵 vt. (使)马以斜横步前进, 使传代
able	a. 能干的, 能够的
past	n. 过去, 昔时, 往事, 早年经历, 过去时a. 过去的, 结束的, 卸任的, 过去时的prep. 越过, 晚于,超越, 超出...的可能性(能力、范围 等)pass的过去分词
ability	n. 能力, 才干[经] 能力, 才能
view	n. 视野, 风景, 见解, 视力, 观看, 视图, 指望, 意图,印象vt. 看, 考虑, 视察, 查看, 估量[计] 视图
read	v. 读, 阅读, 理解a. 有学问的n. 读取, 阅读 [计] 读取
oil	n. 油, 石油, 油画颜料vt. 涂油于, 使融化成油状, 加油于vi. 加燃油, 融化
set	n. 日落, 同伙, 组合, 集合, 装置 vt. 放, 安置, 放置, 设定, 使凝结,点燃, 确定, 点缀,使就位, 树立, 分配, 调整vi. 日落, 凝固, 定型, 搁住, 结果,适合
test	n. 测试, 试验, 化验, 检验, 考验, 甲壳vt. 测试, 试验,化验vi. 接受测验, 进行测试
face	n. 脸, 面容, 正面, 外观vt. 面对, 朝, 正视, 面临vi. 朝, 向[计] 现场可改变的控制元件
access	n. 通路, 入口, 接近, 进入, 使用权,发作vt. 访问, 存取,接近, 使用[计] 访问, 存取
word	n. 话, 消息, 词,诺言, 命令vt. 用言辞表达 [计] 字
continue	vi. 继续, 延续,延长vt. 使继续, 使延长
play	n. 游戏, 游玩, 玩笑, 运动, 比赛, 赌博, 跳动, 表演,剧本v. 玩, 游戏, 假 装, 开玩笑, 比赛,扮演, 演奏, 演戏,传摇曳, (使)跳动[计] 播放
sale	n. 出售, 卖, 拍卖, 销售额, 廉价出售[经] 卖, 出售; 销售(货)
disease	n. 疾病, 弊病 [医] [疾]病
stay	n. 停留, 逗留, 制止, 延缓, 停止, 支柱, 支撑物, 支索vt. 制止, 延缓,坚持, 支持, 支撑,用支索固定vi. 停留, 逗留,暂停, 坚持, 中止
end	n. 结束, 终点, 目标, 末端, 梢, 死亡, 残余v. 结束, 终结, 终止[计] 端; 结束
house	n. 房子, 住宅, 机构, 议院, 家族, 家庭vt. 给...房子住,收藏vi. 住, 躲藏
patient	n. 病人, 承受者a. 忍耐的, 容忍的, 有耐性的, 坚忍的
answer	n. 答案, 回答, 回报, 答辩vt. 回答, 反驳,适应, 响应, 符合vi. 回答, 答应, 负责, 符合, 成功 [计] 用户问题及答案新闻组
focus	n. 焦点, 焦距vi. 聚焦, 注视 vt. 使聚焦, 调焦,集中[计] 焦点
without	prep. 没有, 不,在...之外adv. 在外面, 户外n. 外面, 外部
enough	n. 充足, 够, 很多a. 充足的, 足够 adv. 足够 interj. 够了
percent	n. 百分比, 百分数, 部分[机] 百分率
control	n. 控制, 管理, 克制, 控制器, 操纵装置vt. 控制, 操纵,抑制[计] 控制; 控制器
low	n. 低点, 低价,低, 牛叫声a. 低的, 消沉的,低等的, 浅的, 卑贱的adv. 低下地, 谦卑地, 低vi. 牛叫
train	n. 火车, 列车, 行列, 长队, 一连串的后果, 顺序vt. 训练, 教育,对准vi. 受训练, 锻炼
difficult	a. 困难的
industry	n. 勤劳, 工业, 企业, 产业, 有组织的劳动[经] 工业, 实业
drive	n. 驾车, 快车道,推进力, 驱动, 动力, 击球, 驱动器 vt. 开车, 驱使,推动, 驾驶vi. 开车, 猛击,飞跑[计] 驱动器
save	n. 救球vt. 解救, 挽救,储蓄, 保存, 节省,保留vi. 挽救, 节省,救球prep. 除...之外 [计] 保存
really	adv. 实际上, 真实地, 实在
grade	n. 等级, 年级, 阶段, 成绩, 程度, 坡度, 斜坡vt. 分等, 分级,评分vi. 属于某等级,逐渐变化
role	n. 角色, 职责, 任务[医] 作用, 功用
follow	vt. 跟随, 沿行,遵循, 追求vi. 跟随, 接着n. 跟随, 追随
yet	adv. 还, 尚, 仍然, 已经, 然而 conj. 然而
kind	n. 种类, 性质, 方式a. 亲切的, 仁慈的, 和蔼的
allow	vt. 允许, 同意给予, 承认vi. 容许, 猜想 [计] 允许命令
sense	n. 感应, 感觉, 感官, 意识, 观念, 情理, 知觉, 理智 vt. 感觉, 觉察, 检测[计] 阅读; 检测
meet	n. 会, 集会a. 适宜的, 合适的 vt. 遇见, 引见, 认识, 满足, 对付vi. 相遇, 接触
nurse	n. 护士, 保姆, 奶妈vt. 看护, 照顾,培养vi. 喂奶, 看护病人
support	n. 支持, 支撑, 援助, 供养, 支撑物 vt. 支援, 支撑, 帮助, 支持, 忍受,供养, 证实[计] 后援; 支持
rule	n. 规则, 统治, 控制, 支配, 规律, 标准, 章程, 破折号, 铅线vt. 规定, 统治,管理, 控制, 支配,裁决vi. 统治, 管辖,裁定[计] 规则, 水线
move	n. 移动, 迁居, 步骤vt. 移动, 开动,感动, 搬(家)vi. 移动, 离开, 运行, 迁移, 摇动,搬家, 交往, 进展,脱手[计] 移动; 传送; DOS外部命令:移动文件,
quality	n. 品质, 特性, 才能, 质量a. 优质的 [计] 品质
require	vt. 需要, 命令,要求[法] 需要, 要求,命令
level	n. 水平, 水准, 平地a. 同高的, 平坦的, 齐平的, 水平的vt. 弄平, 夷平,使同等, 瞄准, 对准vi. 变平, 拉平 [计] 级别
lack	n. 缺乏, 无, 不足 vt. 缺乏, 短少, 不足, 需要vi. 缺乏
consider	v. 考虑, 思考, 认为
security	n. 安全, 安全性,防护物, 保安, 可靠性, 担保人, 抵押品, 保证金[计] 安全性, 保密性, 安全检查程序
three	num. 三, 三个
mark	n. 标志, 分数, 马克, 痕迹, 斑点, 靶子, 刻度, 记号,符号, 戳记, 标准,起跑线vt. 做标记于, 留意, 打分数, 表明,标志, 记录vi. 作记号, 记得分[计] 标志
concern	n. 关心, 忧虑vt. 与...有关, 使担心, 使挂念
point	n. 点, 小数点, 标点, 地点, 要点, 特点, 尖端, 分数,得分, 穴位vt. 弄尖, 强调,指出, 加标点于,瞄准vi. 指, 指向, 表明
bad	a. 坏的n. 坏 adv. 坏地
economic	a. 经济上的, 实用的, 节省的[经] 经济的
however	adv. 然而, 无论如何, 究竟怎样 conj. 然而, 可是
position	n. 位置, 地位, 身分, 形势, 姿势, 立场, 职位, 状态,阵地vt. 安置, 决定...的位置[计] 位置
design	n. 设计, 图样, 方案, 企图v. 设计, 计划
talk	n. 谈话, 交谈, 会谈, 讲话, 演讲, 空谈, 谣言, 方言,语言vi. 讲话, 演讲, 说话, 谈话, 交流,闲聊, 说闲话vt. 讲, 说, 讨论,谈论[计] 对话类, 聊天
half	n. 一半, 半场, 不完全a. 一半的, 不完全的, 部分的, 半场的adv. 一半地, 部分地, 在某种程度上地, 几乎
produce	n. 生产品, 物产,后代vt. 产生, 生产,提出, 出示vi. 生产, 制造
society	n. 社会；社交界；交往；社团
worker	n. 工人, 劳动者 [经] 工人, 劳工,劳动者
choice	n. 选择, 精选品,选择权a. 精选的, 挑三拣四的, 上等的[计] DOS内部命令:在批处理文件中该命令用于提示用户作出选择, 决定批处理文件的流程
tend	vi. 走向, 有某种的倾向, 易于, 照顾, 注意vt. 照料, 护理
decade	n. 十年, 十
receive	vt. 收到, 接到,得到, 接待, 迎接,承受vi. 收到, 会客 [计] 接收
water	n. 水, 雨水, 海水, 水位, 水面,流水vt. 给...浇水, 供以水, 注入水, 使湿vi. 流泪, 流口水,加水a. 水的, 水上的,水生的, 含水的
digital	a. 数字显示的, 数字的n. 数字仪表, 数字式电子表(或时钟) [计] 数字, 数字式
consumer	n. 消费者[经] 消费者, 用户
real	a. 真的, 真实的,实际的, 实在的,不动(产)的, 实数的n. 实数, 现实 adv. 真正地
far	a. 远的, 久远的,遥远的adv. 甚远地, 很,到很深的程度, 到很远的距离
prepare	vt. 准备, 筹备, 使在思想上有准备,制造, 调制vi. 预备
global	a. 通用的, 全球的, 球形的, 综合的, 普遍的[计] 共用
visit	n. 拜访, 访问, 游览, 视察vt. 拜访, 访问,参观, 视察, 降临vi. 访问, 参观,闲谈
avoid	vt. 避免, 防止,撤消[法] 避免, 回避,躲开
animal	n. 动物[医] 动物
drink	n. 饮料, 酒v. 喝, 喝酒
always	adv. 总是, 始终
hour	n. 小时, 钟头, 时间, ...点钟, 课时
plan	n. 计划, 方案, 策略, 方法, 进度表,程序表, 平面图, 设计图, 轮廓, 示意图vt. 计划, 设计,意欲vi. 订计划
development	n. 发展[化] 展开
sell	vt. 卖, 背叛, 销售, 出卖vi. 卖, 销售n. 卖, 推销术, 失望
four	num. 四, 四个  [机] 四冲程循环
sign	n. 符号, 招牌, 征兆, 正负号, 手势 vt. 签名, 打手势表达vi. 签名[计] 正负号; 符号; 符号字符
shop	n. 商店, 工厂, 车间vi. 购物, 到处寻找vt. 选购
subject	n. 科目, 主题, 臣民, 主语, 题目,(事物的)经受者,学科, 受治疗者,原因, 理由a. 服从的, 易患...的, 隶属的,受支配的adv. 在...条件下 vt. 使隶属, 使受
mother	n. 母亲, 修女院长 vt. 产生, 照看, 收养
decline	n. 衰退, 跌落, 下降vt. 使降低, 婉谢vi. 下降, 衰落,偏斜
instead	adv. 作为替代, 反而
energy	n. 精力, 精神, 活力, 能量[化] 能; 能量
office	n. 办公室, 部, 公职, 职责[化] 办公室
environment	n. 环境, 外界, 围绕[计] 环境
ago	adv. 以前
affect	vt. 影响, 感动,假装, 模仿, 爱好,倾向于n. 自觉感情
lose	vt. 遗失, 损失,丢失, 使失去, 错过, 浪费, 迷失,使迷路, 输去, 使沉溺于vi. 受损失, 失败
local	a. 地方性的, 当地的, 局部的, 乡土的, 本地的n. 当地居民, 本地新闻, 局部[计] 本地的; 局部
physical	a. 身体的, 物质的, 自然的, 物理学的, 好色的n. 体格检查
success	n. 成功, 成就, 胜利
cry	n. 叫声, 哭声, 大叫vi. 哭, 叫, 喊 vt. 叫喊, 大声说,哭出
healthy	a. 健康的, 有益健康的, 卫生的[医] 健康的
century	n. 世纪, 百年
average	n. 平均, 平均数,一般水平, 海损a. 平均的, 中等的, 平常的vt. 算出...平均数, 平均做, 均分,使平衡vi. 平均为, 呈中间色
rate	n. 比率, 率, 速度, 价格, 费用,等级vt. 估价, 认为,鉴定等级, 责骂vi. 被评价, 责骂
second	n. 秒, 瞬间, 第二名, 支持者, 助手a. 第二的, 其次的, 次要的, 附加的, 辅助的num. 第二vt. 当...助手, 支持
away	adv. 离去
fast	a. 快速的, 紧的 adv. 很快地, 紧紧地, 彻底地n. 绝食, 斋戒vi. 绝食, 斋戒
graduate	n. 毕业生, 量杯a. 已得学位的, 研究生的, 毕业的vi. 毕业, 得学位,逐渐变为vt. 准予...毕业,授予...学位, 分等级, 刻刻度
project	n. 计划, 设计, 事业vt. 计划, 设计,投掷, 发射, 使凸出, 放映vi. 凸出
individual	n. 人, 个人, 个体a. 个别的, 个人的, 独特的
fail	vi. 失败, 缺乏, 中断, 衰退, 失灵 vt. 忘记, 使...失望, 缺乏, 不及格n. 不及格
device	n. 装置, 设计, 策略, 发明物, 设备 [计] 设备; DOS内部命令:该命令要求 DOS安装一个设备驱动程序
type	n. 类型, 样式, 典型, 榜样, 标志, 符号, 型, 式vi. 打字vt. 作为代表, 测定类型, 用打字机打[计] 类型; 键入; DOS内部命令:在屏幕上显示指定文件的内容
top	n. 顶部, 顶端, 极点, 上面, 上部, 顶篷, 最高地位, 首位, 陀螺a. 最高的, 顶上的, 头等的vt. 盖, 加以顶,高达, 超越vi. 结束, 达到顶点, 高出[计] TOP
ever	adv. 曾经, 究竟,永远
survey	n. 纵览, 视察, 测量, 俯瞰, 调查 vt. 审视, 视察, 俯瞰, 通盘考虑vi. 测量土地
break	n. 休息, 中断, 破裂处, 绝交, 破晓,突变vt. 打破, 弄破,弄坏, 破坏, 违反,打断, 削弱, 放弃vi. 破碎, 决裂, 破晓, 突变, 变弱,暂停n. 分隔符 [计]
professor	n. 教授
fact	n. 事实, 真实性,真相, 细节, 论据
doctor	n. 医生, 博士  vt. 授以博士学位,诊断, 修改vi. 行医
restaurant	n. 餐馆, 饭店
several	a. 几个的, 一些的, 各自的 pron. 几个
process	n. 程序, 进行, 过程vt. 加工, 使...接受处理, 对...处置, 对...起诉a. 经加工的, 有特殊光效的[计] 进程
customer	n. 消费者 [化] 顾客
white	n. 白色, 洁白, 眼白, 白种人, 蛋白a. 白色的, 纯洁的, 白种的, 苍白的, 空白的, 幸运的
major	n. 主修课, 成年人, 陆军少校a. 主要的, 较多的, 大部分的, 成年的, 严重的vi. 主修[计] 主要, 主要刻度
week	n. 星期, 周
enjoy	vt. 享受, 喜欢,欣赏[法] 享受, 享有,获得某种利益
strong	a. 强壮的, 坚固的, 坚强的, 强烈的, 有力的, 优良的adv. 强劲地, 有力地, 猛烈地
force	n. 力量, 武力, 势力, 影响力, 军队,力, 效力vt. 强迫, 强夺,推动, 提高[计] 人工转移; 强制
leader	n. 领导者, 社论,指挥, 领袖, 领唱者, 前导字符[计] 前导字符
activity	n. 活动, 行动, 活跃, 活力[计] 活动
growth	n. 生长, 栽培, 增长[计] 等比级数
watch	n. 观察, 手表, 看守, 守护, 监视, 值班人vt. 看, 注视, 照顾, 看守, 守护,监视vi. 观看, 注视,守侯
name	n. 名字, 名称, 姓名, 名义, 名誉, 文件名vt. 命名, 称呼,任命, 提名, 列举a. 姓名的, 据以取名的[计] 名称, 文件名, 姓名
quite	adv. 相当, 完全,十分
professional	n. 专业人才a. 专业的, 职业的
run	n. 跑, 赛跑, 奔跑, 奔跑的路程,趋向, 流出, 运转时间, 连续vi. 跑, 奔跑, 跑步, 赛跑, 竞赛, 行驶, 运转, 进行,蔓延vt. 使跑, 参赛,追究, 驾驶, 开动,
stop	n. 停止, 车站, 逗留, 填塞, 障碍,(风琴的)音栓vi. 停止, 被塞住 vt. 塞住, 堵塞, 阻止, 击落, 停止,终止, 断绝
bring	vt. 带来, 产生,促使, 提出vi. 生产
science	n. 科学, 学科, 学问, 自然科学[医] 科学
order	n. 次序, 规则, 命令vi. 命令, 定货 vt. 整理, 命令,定购n. 顺序, 阶数[计] 顺序, 阶数
personal	a. 私人的, 涉及隐私的, 有人性的, 人称的, 亲自的, 身体的[医] 人的; 个人的, 自身的
hear	vt. 听到, 倾听,听说, 审理vi. 听见, 听
close	n. 结束, 完结a. 靠近的, 亲近的, 亲密的, 严密的, 关闭的, 狭窄的, 秘密的vt. 关, 结束, 使靠近, 封闭, 使接近vi. 关闭, 结束,靠近adv. 接近地, 紧密地
common	a. 通常的, 共同的, 通俗的, 公共的[计] 公用块
soon	adv. 不久, 早,快, 宁可
worry	n. 担心, 烦恼, 忧虑, 苦恼, 撕咬 vt. 使烦恼, 使焦虑, 使苦恼, 困扰,折磨, 撕咬vi. 烦恼, 担心,撕咬
challenge	n. 挑战, 盘问vt. 向...挑战, 要求, 怀疑vi. 挑战, 对(证据等)表示异议
least	n. 最少, 最小, 最小限度a. 最少的, 最小的adv. 最小, 最少
body	n. 身体, 人, 尸体, 主要部分, 团体vt. 赋以形体[计] 体
datum	n. 论据, 材料, 资料, 已知数[医] 材料, 资料,论据
sugar	n. 糖, 糖块, 甜言蜜语vt. 加糖于, 使甜蜜, 粉饰, 美化vi. 制成糖
open	n. 公开, 户外, 空旷a. 开着的, 开放的, 开阔的, 营业着的, 公开的, 悬而未决的vt. 打开, 公开,开放vi. 展开, 开始,展现[计] 打开指令; 打开语句
million	n. 百万, 无数 num. 百万
expect	vt. 预期, 盼望,期待
prove	vt. 证明, 查验,检验, 勘探, 显示vi. 证明是
game	n. 比赛, 玩耍, 比分, 得胜, 比赛规则, 策略, 游戏, 野味vi. 赌博a. 勇敢的, 有胆量的, 关于野味的, 跛的[计] 博弈; 对策
participant	n. 参加者, 参与者a. 有份的, 参加的, 参与的
model	n. 模型, 模范, 模特儿a. 模范的, 作模型用的vi. 做模型, 做模特儿vt. 使模仿, 塑造 [计] 模型
degree	n. 程度, 度数, 学位, 度[医] 度, 程度
add	vt. 增加, 添加,附带说明, 计算...总和vi. 做加法, 积累而成, 增添[计] 加法
explain	v. 解释, 说明
do	v. 做, 进行, 完成
case	n. 情形, 情况, 箱, 容器, 事实,病例, 案例, 框子 vt. 装箱, 包盖
almost	adv. 几乎, 差不多
math	n. 数学
firm	n. 公司, 商号a. 坚定的, 坚强的, 牢固的, 结实的, 坚硬的, 坚挺的, 严格的, 确定的vt. 使牢固, 使坚定vi. 变稳固, 变坚实adv. 稳固地
opportunity	n. 机会, 时机
practice	n. 实践, 练习, 实行, 惯例, 习惯, 开业v. 实践, 实行, 练习, 实习, 业务
population	n. 人口, 人口数 [化] 群体; 总体
effective	a. 有效的, 有力的, 实际的n. 有生力量
night	n. 夜, 夜晚, 晚上, 黑暗, 夜晚的工作[法] 夜, 黑夜, 黑暗
member	n. 成员, 会员[医] │肢, 肢体
actually	adv. 事实上, 竟然, 如今, 现在
law	n. 法律, 法则, 定律, 法律的制约, 法学, 司法界, 诉讼v. 起诉
next	n. 下一个a. 下一个的, 其次的, 贴近的adv. 然后, 下次,次于[计] 近邻干扰
full	n. 全部, 完整a. 充满的, 完全的, 丰富的, 完美的, 丰满的, 详尽的adv. 完全地, 整整, 十分vt. 把(衣服等)缝得宽松, 漂洗[计] 完整
code	n. 代码, 密码, 法规, 法典vt. 把...编码[计] 代码
innovation	n. 改革, 创新[法] 创新, 改革,刷新
never	adv. 从不, 决不,不曾[法] 永不, 决不,从来没有
essay	n. 随笔, 短文, 评论, 企图vt. 试图
decision	n. 决定, 决心, 决断[计] 判定
someone	pron. 有人, 某人
culture	n. 文化, 修养, 耕种vt. 耕种, 培养
trend	n. 趋势, 倾向, 走向vi. 倾向, 转向[计] 趋势
university	n. 大学
amount	n. 总数, 总额vi. 总计, 等同
relationship	n. 关系, 关联 [医] 关系
attention	n. 注意, 注意力  [计] 引起注意信号
impact	n. 冲击, 冲突, 影响, 效果vt. 挤入, 撞击,压紧, 对...发生影响
advance	n. 前进, 进展, 行过的路程vi. 前进, 进展,提高, 上涨vt. 使前进, 促进,提出, 提高, 使提前, 预付a. 前面的, 预先的
mental	a. 心智的, 精神病的, 心理的, 颏的n. 精神病患者
medical	n. 医生, 体格检查a. 医学的, 内科的, 药的
condition	n. 情况, 条件vt. 使健康, 以...为条件, 决定, 使适应[计] 条件
traditional	a. 传统的, 惯例的 [经] 传统的, 惯例的
factor	n. 因素, 因数, 系数, 基因, 代理人 [计] 因式
month	n. 月[经] 月
experiment	n. 实验, 试验, 实验仪器vi. 实验, 尝试
record	n. 记录, 履历, 档案, 审判记录, 最高纪录, 唱片vt. 记录, 记载,标明, 将...录音vi. 记录, 录音,可被录音a. 创纪录的[计] 录制, 记录
item	n. 项目, 条款, 一则, 项[计] 项
forget	vt. 忘记, 忽略,忘vi. 忘记
remember	vt. 记得, 回忆起,记住, 铭记, 纪念vi. 记得
knit	v. 编织, 结合
increasingly	adv. 逐渐地, 渐增地
resident	n. 居民, 常驻程序, 居住者, 留鸟a. 居留的, 定居的
potential	n. 潜在性, 可能性, 潜力, 潜能,势, 位a. 有潜力的, 可能的, 潜在的
habit	n. 习惯, 嗜好, 习性vt. 使穿衣
five	num. 五, 五个
generation	n. 一代, 一世, 产生[医] 生殖, 世代
term	n. 术语, 专有名 词, 期限, 学期, 任期, 条件, 价钱,关系, 地位, 项, 界石vt. 称, 呼[计] 检索词; 项
agree	vi. 同意, 赞成,应允, 适合vt. 承认, 认定,同意
issue	n. 发行, 问题, 后果, 流出, 出口, 争端vi. 发行, 流出, 造成...结果, 传下 vt. 使流出, 放出,发行, 发布, 发给
encourage	vt. 鼓励, 支持,激励[法] 怂恿, 煽动,助长
advice	n. 忠告, 劝告, 意见, 报道, 通知[经] 通知书, 通知, 建议
exam	n. 考试, 测验
line	n. 列, 线, 绳, 电线, 线路, 路线, 航线, 作业线, 界线, 战线, 外形, 排, 家系vt. 排成一行, 顺...排列, 划线于, 加衬里, 使有线条, 使起皱纹vi. 排队 [计]
bacterium	n. 细菌[医] [无芽胞]杆菌属
reach	n. 伸出, 延伸, 区域, 范围, 流域, 岬vt. 到达, 达到,伸出, 延伸, 影响vi. 达到, 延伸,伸出手, 传到
chance	n. 机会, 意外, 可能性vi. 偶然发生vt. 冒险
limit	n. 界限, 边界, 限度, 极限, 限制 vt. 限制, 限定
base	n. 底部, 垒, 基础, 基地vt. 以...作基础a. 卑鄙的, 低劣的 [计] 基准
phone	n. 电话, 受话器,耳机vt. 打电话给vi. 打电话
movie	n. 电影
within	n. 内部, 里头 adv. 在内部, 在内心里prep. 在...之内
return	n. 回来, 返回, 来回票, 归还, 报答,利润率, 报告书a. 返回的, 回程的, 报答的, 反向的, 重现的, 复原的vi. 返回, 归还,回来vt. 归还, 还, 回报, 产生, 反
demand	n. 要求, 需求, 需要v. 要求, 查询
detail	n. 细节, 详情 vt. 详述, 选派vi. 画详图[计] 详细数据
apply	vt. 涂, 应用vi. 申请, 适用
employee	n. 职员, 员工, 受雇人员[化] 职工; 雇员
earn	vt. 赚得, 获得,博得[计] 欧州科学研究网
aging	n. 老化, 变陈[计] 老化, 陈化
speed	n. 速率, 速度, 迅速vi. 加速, 超速,快进vt. 快速传送, 促进, 使加速[计] 中央处理机速度设置程序
matter	n. 事件, 物质, 原因, 素材, 实体, 重要vi. 有关系
though	adv. 然而, 可是 conj. 虽然, 纵然
compare	vt. 比较, 比喻,对照vi. 相比n. 比较[计] 比较
especially	adv. 尤其, 特别,格外
various	a. 不同的, 各种的, 多方面的, 许多的, 个别的, 杂色的[法] 不同的, 种种的, 各式各样的
jam	n. 果酱, 拥塞之 物, 堵塞, 困境 vt. 挤进, 使塞满,混杂, 压碎, 使堵塞vi. 堵塞, 轧住,拥挤
exercise	n. 行使, 执行, 运动, 练习, 作业 vt. 运用, 练习, 运动vi. 练习, 锻炼
depend	vi. 靠, 视...而定, 信赖
floor	n. 地板, 楼层, 底部, 底价vt. 铺地板, 打倒n. 地面, 地板, 基底[计] 基底
card	n. 卡片, 纸牌, 节目单, 明信片, 梳棉机vt. 备置卡片, 记于卡片上, 梳理[计] 卡片, 卡
mind	n. 思想, 愿望, 智力, 记忆, 心理, 情绪, 理智, 主意,心意vi. 介意, 注意,留心vt. 注意, 留意,专心于, 照看, 介意
decide	v. 决定, 判决
power	n. 力, 体力, 力 量, 势力, 动力, 权力, 强国, 乘方,强度, 幂, 功率 vt. 使...有力量,供以动力, 激励[计] 乘幂; DOS外部命令:能控制许多电池电源计算机上的电源管理
remain	vi. 保持, 逗留,剩余[法] 停留, 居住,继续
purpose	n. 目的, 意向, 决心, 用途, 效果, 论题vt. 意欲, 企图,计划
short	a. 短的, 近的, 矮的, 短期的, 简短的, 少量的adv. 简短地, 突然n. 扼要, 短片, 缺乏vt. 故意少给, 使短路
history	n. 历史, 过去, 经历, 发展过程, 历史学, 过去的事, 历史记录[计] 历史记录
True	a. 真实的, 正确的, 忠诚的, 可靠的, 纯粹的, 正式的n. 真实, 准确 adv. 真实地, 准确地
father	n. 父亲, 祖先, 长辈, 神父, 创始者 vt. 当...的父亲,保护, 创作, 发明,培养
raise	n. 上升, 高地, 增高vt. 升起, 举起, 唤起, 提高, 使出现, 使复活, 提出,筹集, 饲养
current	n. 涌流, 趋势, 流a. 流通的, 现在的, 当前的, 流行的[计] 当前的
pressure	n. 压, 榨, 按, 强制, 压力, 压迫, 压强vt. 迫使, 使增压,密封
single	a. 单身的, 单程的, 单一的, 个别的, 孤独的, 专一的n. 一个, 单打, 单程票vt. 选出vi. 击出一垒打 [计] 单精度型
tip	n. 顶, 尖端, 梢,末端, 倾斜, 垃圾场, 小费, 轻击, 指点, 秘密消息 vt. 装顶端, 使倾斜, 使翻倒, 泄露,告诫, 暗示, 给...小费, 轻击vi. 倾斜, 翻倒,倾覆,
ship	n. 船, 舰vt. 以船运送, 装船, 运送vi. 上船, 乘船
usually	adv. 通常, 大抵
similar	a. 相似的, 类似的n. 相似的东西
hold	n. 把握, 把持力,柄, 控制, 掌握,监禁vt. 保存, 握住,拿住, 占据, 持有,拥有vi. 支持, 持续,有效n. 保留[计] 保留
sometimes	adv. 有时, 时常,往往
minute	n. 分, 分钟, 片刻, 备忘录, 笔记 vt. 记录, 摘录,测定时间a. 微小的, 详细的
gender	n. 性 vt. 产生
tear	n. 泪滴, 眼泪, 撕, 扯, 裂缝, 激怒, 飞奔vi. 流泪, 撕破,赶快, 飞奔, 被撕破vt. 撕裂, 戳破,拉掉, 撕掉, 使分裂, 使精神不安,折磨
check	n. 检查, 支票, 阻止物, 寄物牌, 象棋中将军vt. 检查, 阻止,核对, 寄存, 托运vi. 逐项相符, 开支票[计] 复选
carry	n. 进位, 射程, 运载vt. 携带, 运送,支持, 传送, 包含vi. 被携带, 能达到[计] 进位; 进位数
sit	vi. 坐, 就座, 坐落vt. 使就座, 骑n. 坐, 衣服合身
love	n. 爱, 恋爱, 爱情, 爱好, 性爱 vt. 爱, 爱好, 爱慕vi. 爱
certain	a. 确定的, 某一个的, 必然的[法] 确凿的, 无疑的, 可靠的
popular	a. 通俗的, 流行的, 受欢迎的, 大众的, 人民的, 普及的[经] 大众的, 通俗的, 普及的
shift	n. 变化, 移动, 轮班, 手段, 应急办法, 移位vt. 替换, 转移,改变, 推卸, 变速vi. 转换, 移动, 转变, 推托, 变速 [计] DOS内部命令:该命令可将批处理参数向左移动
credit	n. 信用, 信任, 荣誉, 贷款, 学分 vt. 归功于, 赞颂,信任, 相信[计] 信用量
language	n. 语言, 文字, 措辞[计] 语言
let	vt. 让, 假设, 出租, 排放, 妨碍vi. 出租, 被承包n. 出租屋, 障碍
although	conj. 虽然, 尽管
available	a. 可利用的, 可获得的, 有效的[医] 有效的, 可得的
rich	a. 富裕的, 富饶的, 浓厚的, 贵重的
beyond	prep. 超过, 在那一边, 迟于adv. 在远处n. 更远处
academic	a. 学院的, 学术的, 不切实际的n. 大学生, 大学教师, 学者, 学会会员
hope	n. 希望, 信心, 期待v. 希望, 期望, 信赖
influence	n. 影响力, 权力,势力vt. 影响, 改变
driver	n. 驾驶员, 驱动器, 驱动程序[化] 驱动器
tax	n. 税, 税款, 重负, 会费vt. 课以税, 使负重荷, 斥责
risk	n. 冒险, 危险, 保险额vt. 冒...的危险,冒险干
story	n. 故事, 小说, 传奇, 描述, 阅历, 经历, 层
difference	n. 不同, 差异 [计] 差分
safety	n. 安全, 保险, 平安, 保安设备vt. 保护, 防护
clear	a. 清楚的, 明确的, 澄清的adv. 清晰地vt. 澄清, 清除障碍vi. 放晴, 变清澈n. 空隙[计] 清除
field	n. 领域, 田地, 场地, 战场, 场, 域 vt. 使...晒在场 上, 使上场a. 田间的, 野生的, 野外的, 田赛的[计] 域, 字段
knowledge	n. 知识, 学问, 认识, 知道
generally	adv. 通常, 逐渐地, 普遍地
prevent	v. 预防, 防止, 阻止, 妨碍
complete	a. 完全的, 十足的, 完成的vt. 完成, 完工,使圆满
free	a. 自由的, 享受政治权力的, 允许的,免费的, 丰富的 vt. 释放, 解放, 使自由adv. 自由地, 免费
clean	a. 干净的, 清白的, 简洁的adv. 清洁地, 完全地vt. 清理, 使干净,出空vi. 被搞干净n. 打扫
tourist	n. 观光客, 旅行者a. 旅游的
warm	a. 暖和的, 暖的,温暖的, 热烈的, 兴奋的, 激烈的, 多情的, 色情的 vt. 使温暖, 弄热,使兴奋, 使充满仇恨vi. 变暖和, 变温暖, 取暖, 激动,同情, 爱好n. 暖,
action	n. 行动, 活动, 动作, 作用, 战斗, 行为, 诉讼vt. 对...起诉 [计] 方式
identify	vt. 识别, 认为...等同于, 确定, 使参与vi. 一致, 认同
community	n. 社区, 公众, 共有, 共同体[经] 公众, 共有,社会
egg	n. 蛋, 卵vt. 挑唆, 煽动,调蛋黄
probably	adv. 大概, 或许
perhaps	adv. 也许, 大概
list	n. 目录, 名单, 明细表, 布条, 条纹,列表, 序列, 数据清单vt. 列出, 列于表上, 记入名单内,装布条vi. 列于表上[计] 列表, 序列,数据清单
room	n. 房间, 空位, 场所vi. 住宿, 居住 vt. 留宿
cover	n. 盖子, 封面, 藉口vt. 覆盖, 掩饰,保护, 掩护, 包括vi. 覆盖
travel	n. 旅行, 游历, 行进vi. 旅行, 行进,移动, 被传播 vt. 旅行, 通过,使移动
measure	n. 尺寸, 量度器,量度标准, 测量, 量具, 程度, 范围,限度, 分寸, 措施,方法vt. 测量, 测度,估量, 权衡, 调节,拿(自己或自己的力量等)作较量vi. 度量
happy	a. 快乐的, 幸福的, 愉快的, 恰当的
supply	n. 补给, 供给, 供应品vt. 补给, 供给,提供, 补充vi. 替代
ancient	a. 古代的, 古老的, 年老的, 旧的
cheap	a. 便宜的, 不值钱的, 可鄙的adv. 便宜地
successful	a. 成功的, 一帆风顺的, 顺利的[经] 成功的
smoke	n. 烟, 雾气, 烟熏剂, 抽烟, 烟色vi. 吸烟, 冒烟,弥漫vt. 以烟熏, 抽烟而导致...
everyone	pron. 每个人, 人人[计] 系统中的一个组名
scientist	n. 科学家[医] 科学家
seek	vt. 寻求, 寻找,探索, 追求, 搜索,请求vi. 寻找, 搜索 [计] 查找
area	n. 区域, 面积, 范围, 空地[计] 区域
reward	n. 报酬, 酬谢, 赏金vt. 奖赏, 酬谢,给...应有报应
across	prep. 越过, 穿过,与...相交叉,在...的对面adv. 交叉, 到另一边, 在对面, 成十字
textbook	n. 教科书
hotel	n. 旅馆, 客栈
news	n. 新闻, 消息, 报导[法] 新闻, 消息,新闻报导
effort	n. 努力, 成就
goal	n. 目标, 终点, 得分, 球门, 守门员vi. 攻门, 射门得分
stress	n. 压力, 紧迫, 强调, 重音, 重点, 应力vt. 加压力于, 着重, 重读
curiosity	n. 好奇心, 新奇的事物, 珍品
achieve	vt. 完成, 达到vi. 如愿以偿
present	n. 现在, 礼品, 瞄准a. 现在的, 出席的 vt. 介绍, 引见, 赠送, 提出, 呈现,上演vi. 举枪瞄准
function	n. 官能, 职务, 功能, 函数vi. 活动, 运行,行使职责[计] 功能, 函数
involve	vt. 包括, 使陷于,潜心于, 包围[医] 累及, 牵涉,包含
center	n. 中心, 中心点,中锋a. 中央的, 位在正中的vt. 集中, 定中心vi. 居中[计] 居中; 中央
tool	n. 工具, 机床, 傀儡vt. 用工具加工vi. 使用工具
engineer	n. 工程师, 工兵 vt. 设计, 监造,精明地处理, 策划
engage	vi. 答应, 从事,交战vt. 使忙碌, 雇佣,预定, 使从事于, 使参加
situation	n. 情形, 境遇, 位置[医] 情境, 处境
exist	vi. 存在, 生存,发生
poor	a. 贫穷的, 贫乏的, 不幸的, 可怜的, 拙劣的, 卑鄙的[经] 低劣的, 不良的
policy	n. 政策, 方针, 策略, 保险单[医] 凭单, 保险单
height	n. 高度, 海拔, 高地, 顶点[化] 高度
district	n. 区域, 地方[医] 地区, 地段
management	n. 经营, 支配, 管理[化] 管理处
death	n. 死亡[医] 死亡
main	n. 主要部分, 干线, 体力, 力量,主群组a. 主要的, 重要的, 全力的[计] 主群组
cut	n. 切口, 割伤, 降低, 切, 割, 砍, 削, 伤口, 削减, 缩短, 删节, 通路a. 经切割的, 缩减的vt. 切, 割, 减少,刺痛, 开辟, 雕刻,删节, 缩短, 停止,排斥,
solve	vt. 解决, 付给,溶解vt. 求解vi. 求解 [计] 求解
instance	n. 建议, 情况, 例子, 场合vt. 引以为例, 举例说明
nation	n. 国家, 民族[法] 民族, 国家
due	n. 应得的东西, 应付款a. 到期的, 应得的, 应付的, 约定的
protect	vt. 防卫, 保护,警戒[法] 庇护, 保护,警戒
leadership	n. 领导能力, 领导阶层
rend	vt. 分裂, 劈开,强夺, 撕碎, 划破vi. 撕开, 裂开
educational	a. 教育的, 教育性的
attack	n. 攻击, 抨击 vt. 攻击, 抨击,动手干vi. 攻击
hospital	n. 医院[医] 医院
fast-food	a. 供应速食的n. 快餐
obesity	n. 肥胖[医] 肥胖, 多脂
machine	n. 机器, 机械装置, 机构, 自动售货机, 机械般工作的人vt. 以机器制造
serious	a. 严肃的, 认真的, 重要的, 严重的[电] 严重的
alcohol	n. 酒精, 酒[化] 醇; 乙醇; 酒精
road	n. 路, 道路, 公路, 途径, 方法[法] 公路, 道路,行车道
promote	vt. 促进, 晋升,创办, 推销[经] 促进, 推广,推销
speak	vi. 说, 说话, 演说, 发言vt. 说, 讲, 说出
resource	n. 资源, 财力, 办法, 策略, 急智, 消遣[计] 资源
note	n. 笔记, 记录, 注解, 票据, 符号, 显要, 注重, 便笺,照会vt. 记录, 注解,注意
evidence	n. 根据, 证据, 迹象[经] 证据, 凭证
side	n. 旁边, 侧, 方面, 胁, 侧边, 血统a. 旁的, 侧的, 次要的vt. 同意, 支持vi. 支持, 赞助
draw	vi. 拉, 拖, 拔剑 vt. 拖拉, 挨近,领取, 打成平局,引导, 抽签决定,画, 描写, 制订,草拟, 吸引n. 拉, 拖, 拔出,抽签, 平局[计] 翻牌, 绘图
manager	n. 经理, 管理员,管理器[计] 管理器
treat	n. 宴请, 款待 vt. 视为, 对待,论述, 治疗, 款待vi. 讨论, 谈判,作东
quit	vi. 离开, 辞职,停止vt. 离开, 放弃,使解除, 停止n. 离开[计] 结束, 退出
investment	n. 投资[医] 包埋料, 围模料, 包埋法, 围模法
retirement	n. 退休, 隐居, 撤退[经] 退休, 退股,(固定资产)报废
income	n. 收入, 收益, 流入[经] 收益
material	n. 材料, 物资, 素材, 布料, 资料a. 物质的, 肉体的, 重要的
couple	n. 对, 夫妇, 数个 vt. 使成双, 连接,使成婚, 把...联系起来vi. 结合, 成婚
competition	n. 竞争, 竞赛[经] 竞争, 竞销,比赛
joy	n. 欢喜, 乐事, 高兴vt. 使快乐, 令人高兴vi. 欢喜
surface	n. 面, 表面, 水面, 外表, 平面a. 表面的, 外观的, 肤浅的, 水面上的vt. 使成平面, 使浮出水面vi. 浮出水面, 呈现, 在地面上工作
expensive	a. 贵的, 奢华的,费用浩大的, 乱化钱的[经] 高价的, 昂贵的, 浪费的
grain	n. 谷粒, 颗粒, 谷类, 纹理, 本质v. (使)成谷粒
promise	n. 诺言, 约定的事情, 有指望vt. 允诺, 约定,预示vi. 允诺, 有前途,有指望
gain	n. 增益, 获得, 利润, 收获, 增加 vt. 得到, 增进, 赚到vi. 获利, 增加 [计] 增益
female	n. 女性, 女人, 雌性动物a. 女性的, 女子的
trip	n. 旅行, 绊倒, 摔倒, 失足, 差错, 旅程vt. 使跌倒, 使犯错, 使失败vi. 轻快地走, 绊倒, 失误, 犯错,结巴, 旅行, 远足
store	n. 商店, 贮藏, 仓库, 备用品, 存储器vt. 储存, 贮藏,供给vi. 贮藏a. 贮藏的, 现成的 [计] 存储器操作;存储
surprise	n. 惊奇, 奇袭, 诧异vt. 使惊奇, 撞见,奇袭
finding	n. 发现, 发现物,决定, 裁决[法] 调查结果, 对事实的认定, 判定的要素
either	a. (两者之中)任一的, (两者之中)各一的pron. (两者之中)任一conj. 或, 要么
purchase	n. 购买, 购买品,紧握, 绞辘vt. 购买, 赢得,努力取得, 用滑轮起(锚等)
deep	a. 深的 adv. 深入地n. 深渊, 深处
financial	a. 财政的, 金融的 [经] 财政的, 金融的, 财务的
bike	n. 自行车, 脚踏车
highly	adv. 非常, 非常赞许地[电] 大大地
improvement	n. 进步, 改善, 利用[医] 改善, 好转,进步
bank	n. 银行, 堤, 岸 [医] 库
serve	vt. 可作...用, 服务, 经历, 招待, 供应, 送交, 对待vi. 服务, 服役, 侍应, 适合, 有用,开球n. 发球, 轮到发球
drop	n. 滴, 微量, 落下, 空投vi. 放下, 掉下,下降vt. 使滴下, 放下,丢失, 遗漏[计] 投入, 投入点, 接入点, 分接点
recently	adv. 最近
boost	n. 推进, 吹捧 vt. 推进, 提高,宣扬, 促进
cat	n. 猫, 恶妇vi. 呕吐计算机辅助教育,计算机辅助测试,计算机辅助翻译,计算机辅助排版[计] 计算机辅助教学, 计算机辅助翻译, 计算机辅助排字, 计算机辅助测试
moment	n. 片刻, 瞬间, 重要, 阶段, 力矩[医] 片刻, 瞬间,时机, 因素, 矩
simply	adv. 简单地, 只 是, 简直, 简朴地,坦白地
natural	n. 白痴a. 自然的, 自然界的, 本能的, 天然的, 物质的, 正常的, 原始的, 自然数的
charge	n. 指控, 费用, 冲锋, 电荷, 炸药, 主管, 被托管人, 命令vt. 控诉, 加罪于,使充满, 使充电, 使承担vi. 冲锋, 要价,收费
rest	n. 休息, 睡眠, 安息, 稍息, 静止, 支架, 休息处, 其余者, 剩余部分vi. 休息, 睡, 长眠, 安心, 静止,停止, 安置, 依赖 vt. 使休息, 使支撑, 把...寄托于
production	n. 制造, 生产, 产物[医] 产生, 生成
suffer	vt. 遭受, 经历,忍受vi. 受痛苦, 受损害
fear	n. 恐怖, 害怕, 担心v. 害怕, 恐惧,为...担心, 敬畏
majority	n. 多数, 大半 [计] 多数逻辑
trouble	n. 烦恼, 麻烦, 困难, 动乱, 故障 vt. 困扰, 麻烦, 使烦恼, 折磨vi. 烦恼, 费心
quickly	adv. 很快地
educate	vt. 教育, 培养,训练
task	n. 工作, 任务, 作业, 困难的工作 vt. 派给...工作,使辛劳[计] 任务
billion	num. 十亿, 十亿个
bear	n. 熊vt. 忍受, 支承,产生, 怀有, 通过卖空使跌价vi. 忍受, 结果实,压挤, 行进, 转向
message	n. 消息, 通讯, 讯息, 教训, 预言, 广告词vt. 通知vi. 通报, 报告,报信[计] 报文; 消息;信息
ready	n. 预备好的状态,现款a. 准备好的, 备用的, 可以使用的 adv. 预先, 迅速 vt. 使准备好
national	a. 国家的, 国立的, 全国性的, 民族的[经] 全国性的, 国家的, 国民的
famous	a. 出名的, 极好的
fix	vt. 使固定, 修理,准备, 安装, 凝视,牢记, 确定, 整理vi. 固定, 注视,确定n. 困境, 方位, 维修, 贿赂
eye	n. 眼睛, 视力, 看 vt. 看, 注视
medium	n. 媒体, 方法, 媒介a. 半生熟的, 中间的[计] 媒体, 中
direction	n. 方向, 指导, 趋势[计] 方向; 流向
hire	n. 租金, 租用, 雇用vt. 雇请, 出租vi. 受雇
else	a. 别的, 其他的 adv. 另外, 否则,不然
consumption	n. 消费, 消费量,痨病[化] 消耗量; 耗量
contact	n. 联系, 交际, 熟人, 接触vi. 接触, 联系vt. 使接触
technological	a. 技术的[经] 工艺的, 技术的
marry	vt. 与...结婚,娶, 嫁vi. 结婚
smart	a. 聪明的, 漂亮的, 刺痛的, 剧烈的, 敏捷的, 巧妙的, 伶俐的, 潇洒的n. 刺痛, 痛苦vi. 刺痛
intelligence	n. 智力, 情报, 信息[医] 智力
consume	vt. 消耗, 消费,消灭vi. 耗尽, 毁灭
few	a. 很少的, 不多的, 少数的n. 少数
head	n. 头, 头脑, 领袖, 脑袋, 最前的部分vt. 为首, 朝向,前进, 用头顶vi. 朝特定方向行进, (作物)结穗a. 头的, 在顶端的, 主要的[计] 磁头; 冲头
green	n. 绿色, 绿色颜料a. 绿色的, 未成熟的, 新鲜的, 青春的, 无经验的, 脸色发青的
pattern	n. 模范, 典型, 式样, 样品, 图案, 格调, 模式vt. 模仿, 仿造,以图案装饰vi. 形成图案[计] 模式, 图案
film	n. 软片, 薄膜, 胶卷, 电影vt. 覆以薄膜, 拍摄vi. 生薄膜, 拍电影
software	n. 软件[计] 软设备
easily	adv. 容易地, 轻易地, 流利地
responsibility	n. 责任, 职责, 负担, 可靠性[化] 职责
walk	n. 走, 散步, 步行, 行走的路程,竞走, 散步场所vi. 走路, 步行,处世vt. 走过, 遛, 使走, 护送...走
camera	n. 照相机, 摄影机, 密谈室, 暗箱 [计] 摄影
department	n. 部门, 系, 机关 [医] 部, 科
partner	n. 合伙人, 股东,伙伴, 伴侣vt. 与...合伙, 组成一对vi. 做伙伴, 当助手
slow	a. 慢的, 缓慢的,迟缓的, 迟钝的, 冷漠的, 落后的 adv. 慢地, 迟缓地v. (使)慢下来
toilet	n. 厕所, 梳妆vi. 梳妆, 打扮,上厕所vt. 给...梳妆打扮
picture	n. 图画, 照片, 景色, 美丽如画的人 (或物), 化身, 生动的描述, 想像, 形象思维vt. 画, 拍摄, 用图说明, 描写, 想像[计] 图象; 形象;字形
balance	n. 平衡, 差额vi. 平衡, 相等 vt. 称, 权衡, 比较, 使平衡, 结算,抵消
account	n. 报告, 解释, 估价, 理由, 利润, 算账, 帐目vi. 报帐, 解释,导致, 报偿, 占,杀死vt. 认为[计] 帐户, 帐号
facility	n. 容易, 灵巧, 设备[计] 设施; 设备;装备
replace	vt. 代替, 替换,放回, 归还[计] 替换; DOS外部命令:取代或更新文件
marriage	n. 婚姻, 结婚, 婚礼, 合并[医] 婚姻, 结婚
basic	n. 基本原理, 要素, 基本规律a. 基本的, 碱性的 (计算机)BASIC语言
response	n. 反应, 回答, 响应[计] 应答
safe	n. 保险箱, 冷藏室a. 安全的, 可靠的, 平安的, 稳健的, 有把握的
sound	n. 声音, 语音, 吵闹, 声调, 听力范围, 探条, 海峡a. 健全的, 可靠的, 合理的, 健康的, 彻底的, 资金充实的adv. 彻底地, 充分地vi. 发出声音, 回响, 测深, 试探
enable	vt. 使能够[计] 允许, 使能,打开
consequence	n. 结果, 重要性 [法] 结果, 后果,推断
specific	n. 特效药, 特性a. 特殊的, 明确的, 具有特效的,特定地, 具体地
particularly	adv. 特别, 格外,尤其, 详细地, 细致地
negative	n. 否定, 否定语,负数, 底片a. 否定的, 消极的, 负的, 阴性的n. 负数, 负值[计] 负数, 负值
source	n. 来源, 水源, 根源, 原始资料, 源 [计] 来源, 源程序
recession	n. 后退, 凹处, 衰退, 归还[医] 退缩
approach	n. 接近, 入门 vt. 接近, 近似,找...商量vi. 靠近
middle	n. 中央, 中间, 腰部a. 中央的, 中庸的, 中间的
traffic	n. 交通, 通行, 运输, 交通量, 贸易,交易, 交往, 通信量vi. 交易, 做买卖 vt. 用...作交换  [计] 通信量, 传输量
invest	vt. 投资, 花费,笼罩, 授予vi. 投资, 利用
argue	vi. 提出理由, 争论, 辩论vt. 主张, 辩论,证明, 说服
together	adv. 一起, 共同,彼此
anything	pron. 任何事
loan	n. 贷款, 借出v. 借, 供应货款,借给
expert	n. 专家, 行家a. 老练的, 内行的, 专门的[计] 高级
medicine	n. 药, 医学, 内科 vt. 给...用药
classroom	n. 教室
expense	n. 费用, 代价, 开支, 损失[经] 费用, 开支,将支出转为费用
environmental	a. 周围的, 环境的 [经] 环境的, 环保的
party	n. 宴会, 党, 政 党, 团体, 当事人,聚会v. 举办聚会
fire	n. 火, 炉火, 电 炉, 火灾, 闪光体,炮火, 热情vt. 点燃, 烧制,使发光, 激动, 放枪, 解雇vi. 着火, 烧火,开枪, 射击, 激动
search	n. 搜寻, 查究v. 搜寻, 搜查, 探求, 调查, 搜索[计] 搜索, 路径检索程序
contribute	vt. 有助于, 捐助,投稿vi. 出力, 捐献,投稿
score	n. 得分, 抓痕, 二十个, 刻痕, 帐目,乐谱, 起跑线, 终点线, 大量vt. 刻划, 划线, 获得, 评价, 把...记下vi. 刻痕, 记分,得分[计] 得分
male	n. 男人, 雄性动物a. 男性的, 雄性的, 有力的
previous	a. 早先的, 前面的, 过急的[法] 以前的, 生前的, 前述的
worth	n. 价值, 财产a. 值...的, 值得的
mistake	n. 错误, 误会vi. 犯错, 误认 vt. 误解, 弄错 [计] 错误
range	n. 排, 行, 山脉,范围, 行列, 射程 vt. 排列, 归类于,使并列, 放牧vi. 平行, 延伸,漫游[计] 量程; 范围;域; 距离
everything	pron. 每件事物,所有事物
characteristic	n. 特性, 特征, 特色a. 特性的, 特有的, 有特色的[计] 阶; 指数
special	n. 专辑, 专车, 号外, 特别的东西, 负有特别任务的人员a. 特别的, 专门的, 特殊的, 额外的, 附加的, 特别亲密的
necessary	a. 必要的；必然的；必需的
bite	n. 咬, 一口v. 咬, 刺痛, 穿透
sink	n. 藏垢的场所, 沟渠, 污水槽vi. 下沉, 沉没, 下陷, 减弱, 衰退,消沉, 堕落, 渗透 vt. 使低落, 使下沉, 陷于, 投入(资金等), 挖掘
heart	n. 心, 心脏, 中心, 内心, 感情,精神, 心情, 宝贝儿vt. 鼓励
protection	n. 保护, 防卫, 贸易保护制度[计] 保护
staff	n. 全体人员, 工作班子, 棍棒, 杆, 拐杖, 支柱, 权杖a. 职员的, 雇员的, 参谋的vt. 为...配备人员
crisis	n. 危机, 危险期,紧要关头[医] 危象; 骤退,临界, 极期
pick	n. 精选, 选择,掘, 精华, 牙签,鹤嘴锄v. 摘, 掘, 凿,挖, 挑选[计] 拾取
dream	n. 梦, 空想, 愿望v. 做梦, 想象, 梦想
loss	n. 损失, 遗失, 失败, 输, 错过, 伤亡[化] 损失; 损耗
concept	n. 观念, 概念 [医] 概念
expand	vt. 使膨胀, 详述,扩张vi. 张开, 发展 vt. 展开vi. 展开[计] 展开; DOS外部命令:将原始DOS磁盘上的压缩文件解压缩并拷贝到硬盘上
trade	n. 贸易, 商业, 交易, 生意, 职业, 顾客, 信风vi. 进行交易, 做买卖, 经商, 对换,购物vt. 用...进行交换
gift	n. 礼物, 赠予, 天才vt. 赋予
air	n. 空气, 旋律, 态度vt. 晾, 使通风,夸耀
stage	n. 阶段, 舞台, 场所, 戏剧, 站, 驿站, 级, 层, 脚手架vt. 上演, 表演,筹划vi. 适于上演, 乘驿车旅行
send	vt. 发送, 使进入,寄, 派遣, 发射, 使陷于vi. 寄信, 派人,播送n. (船的)上升运动[计] 发送
accident	n. 意外事件, 机遇, 事故, 次要方面[化] 意外事故; 事故
ensure	vt. 确定, 保证,担保, 保护[经] 确保, 确定
sure	a. 确信, 必然的,必定的adv. 当然, 确实地, 无疑地
positive	a. 肯定的, 积极的, 有把握的[医] 正的, 阳性的
act	n. 行动, 行为,幕, 法案vi. 行动, 表演, 假装, 见效, 表现,担当vt. 扮演, 装作  [计] 先进通信技术, 先进计算机工艺, 自动代码翻译技术
assignment	n. 分配, 功课, 任务, 转让, 归因, 陈述[计] 赋值
particular	n. 一项(或条、点), 个别项目, 详细说明a. 特别的, 独有的, 挑剔的, 详尽的
diet	n. 日常饮食, 议会 vt. 照规定饮食vi. 忌食
baby	n. 婴孩[医] 婴儿
illness	n. 疾病, 恶意 [医] 病
pleasure	n. 快乐, 愉快, 令人高兴的事, 娱乐,希望v. (使)高兴
alone	a. 孤独的, 单独的, 独自的adv. 独自地
owner	n. 拥有者, 物主,所有人[经] 所有者, 物主, 业主
fat	n. 脂肪, 脂油, 肥肉a. 肥的, 胖的, 油腻的n. 文件分配表[计] 文件分配表
occur	vi. 发生, 被想到,存在
personality	n. 个性, 人格, (团体、地方、国家)特有特性, 名人 [医] 人格; 个性
already	adv. 已经, 早已
event	n. 事件, 结果, 事情的进程, 竞赛项目[计] 事件
display	n. 显示, 陈列, 炫耀, 显示器vt. 陈列, 显示,表现, 夸示[计] 显示器; 显示
imagine	vt. 想像, 设想,猜测vi. 想像起来
solar	a. 太阳的, 日光的, 源自太阳的[医] 太阳的; 腹腔丛的
attend	vt. 参加, 照料,伴随vi. 专心于, 照顾,服侍, 出席
appetite	n. 食欲, 欲望, 爱好[医] 食欲
contain	vt. 包含, 容纳,控制vi. 自制
network	n. 网络, 广播网,网状物[计] 网络
nearly	adv. 几乎, 密切地
writer	n. 作家, 撰稿者,抄写员[化] 记录器
hurt	n. 伤害, 创伤, 损害v. 伤害, (使)伤心, 危害, 刺痛
significant	a. 重要的, 有效的, 有含义的, 暗示的, 值得注意的
divorce	n. 离婚vt. 与...离婚
belief	n. 信念, 相信, 信仰
nothing	n. 无, 不关紧要之事, 零adv. 毫不, 决不 interj. 什么也没有, 无
interaction	n. 交互作用, 交感 [计] 交互作用
appear	vi. 出现, 显得,来到[法] 出庭, 到案,出现
along	adv. 平行地, 向前 prep. 沿着
prefer	vt. 宁可, 较喜欢,提出[法] 给予优先权,优先偿还, 提出
realize	vt. 了解, 实现,使显得逼真, 变卖vi. 变卖
print	n. 打印, 版, 印刷物, 痕迹, 印刷业,印刷字体, 图片, 印花布, 印章v. 打印, 印刷, 铭记, 留印记于, 用印刷体写[计] DOS外部命令:在打印机上打印文件, 可一边打印文件一
regulation	n. 规则, 管理, 调整[计] 调整; 规章;规则; 调节
variety	n. 多样, 种类, 变种, 杂耍[化] 变种
overall	a. 全部的, 全体的, 从头至尾的,一切在内的adv. 从头到尾, 总的说来n. 罩衫, 工作服
agent	n. 代理商, 政府代表, 动原, 媒介[计] 代理程序
taste	n. 味道, 品味, 味觉, 感受, 体验, 爱好, 审美, 少量 vt. 尝, 察觉...的味道, 体会vi. 品尝, 察觉味道, 有某种味道
participate	vi. 参加, 分享,参与, 带有vt. 分享, 分担
depression	n. 不景气, 消沉,沮丧, 洼地[医] 抑郁[症], 阻抑, 压低, 凹, 窝,衰退, 俯角
stick	n. 棍, 棒, 刺, 枯枝, 茎, 条状物 vt. 插进, 刺入, 钉住, 伸出, 粘贴,停止vi. 粘住, 停留,坚持, 陷住, 伸出
park	n. 公园, 停车处 vt. 停车, 置于vi. 停车
whole	n. 全部, 全体, 整体, 完全之体系a. 所有的, 完整的, 完全的, 纯粹的
kitchen	n. 厨房, 全套炊具 [医] 厨房
standard	n. 标准, 规格,旗, 军旗, 本位a. 标准的, 合规格的[计] 标准
carefully	adv. 小心地, 谨慎地
talent	n. 天才, 才能, 有才干的人, 天资
address	n. 住址, 演说, 举止, 灵巧, 求爱 vt. 发表(演说或讲话), 对付, 写地址 [计] 地址, 寻址
equipment	n. 装备, 设备, 才能[化] 设备; 装备;装置
video	n. 影像, 电视a. 图像的, 电视的
feed	n. 饲料, 一餐, 饲养vt. 喂, 饲养, 放牧, 靠...为生vi. 吃东西, 用餐,流入[计] 送纸
despite	n. 轻视, 憎恨 prep. 虽然, 尽管
application	n. 应用, 申请, 志愿书, 应用程序[计] 应用, 应用程序
executive	n. 执行部门, 执行委员会, 执行者, 经理主管人员a. 执行的, 善于执行的, 善于经营的 [计] 执行程序
claim	n. 要求, 要求权,断言, 权利vt. 要求, 认领,主张vi. 提出要求, 主张, 断言
decrease	n. 减少, 减少量v. 减少
necessarily	adv. 必然地, 必须地, 必要地
vehicle	n. 交通工具, 车辆, 传播媒介[化] 载体; 运载体; 漆料
near	a. 近的, 近亲的,近似的adv. 接近, 亲近 prep. 靠近, 近似于v. 接近, 走近
appeal	n. 恳求, 诉请, 上诉, 吸引力vi. 呼吁, 诉请,要求, 上诉, 有吸引力vt. 将...上诉
correspond	vi. 符合, 通信,相当[法] 符合, 一致,相当
town	n. 城镇, 市, 镇 [法] 城镇, 城市,闹市
debt	n. 债务, 罪过[经] 借款, 欠款,债务
huge	a. 极大的, 巨大的, 无限的
discover	vt. 发现, 找到,暴露vi. 发现
damage	n. 损害, 伤害v. 损害
expectation	n. 期待, 指望, 展望[化] 期望值
light	n. 光, 光亮, 灯,日光, 发光体, 光源, 杰出人物, 火花, 眼光a. 轻的, 少量的,轻微的, 轻快的,轻浮的, 明亮的,淡色的, 容易的 vt. 点燃, 照亮vi. 点着, 变
associate	n. 同伴, 伙伴, 关联的事物vt. 使联合, 使发生联系vi. 交往 [计] 关联
performance	n. 施行, 工作情况, 成绩, 行为,表现, 演出[电] 绩效, 性能
workforce	n. 劳动力；工人总数, 职工总数
wait	n. 等待, 等候 vt. 等候, 期待,延缓, 伺候, 推迟vi. 等, 等候, 耽搁, 伺候用餐[计] 等待
step	n. 步骤, 步, 步 幅, 脚步声, 踏级,步伐, 短距离, 步态, 手段, 等级 vt. 踏, 以步测量,跨步, 使成阶梯状vi. 跨步, 轻快地走, 跳舞, 踩, 踏上, 行走[计] 步骤
private	a. 私人的, 秘密的, 私立的, 隐蔽的n. 士兵, 隐士, 阴部[计] 私人的
robot	n. 机械人, 自动机械, 机械般工作的人[计] 机器人; 自动机
rely	vi. 信赖, 依赖,信任
fight	n. 打架, 争吵, 斗志v. 对抗, 打架
hunger	n. 饥饿, 渴望, 饥荒vt. 使挨饿vi. 挨饿, 渴望
option	n. 选择权, 挑选,选项[计] 选项
pollution	n. 污染, 玷污 [化] 污染
fashion	n. 流行, 风尚, 时样vt. 形成, 造, 作
craft	n. 技艺, 手艺, 诡计vt. 精心制作
reserve	n. 储备品, 贮量,后备军, 自然保护区, 保留, 拘谨,节制, 储备金vt. 保留, 保存,预订, 延期, 推迟
die	vi. 死亡, 消逝, 平息, 熄灭, 漠然,渴望vt. 死n. 骰子, 冲模
explore	v. 探险, 探测, 探究
shortage	n. 不足, 缺乏 [化] 缺额
gap	n. 缝隙, 缺口, 间断, 间距, 通用汇编程序vt. 打开缺口, 造成缝隙vi. 豁开[计] 通用汇编程 序, 图形应用程序,间距
desire	n. 欲望, 要求 vt. 想要, 请求vi. 渴望
modern	n. 现代人, 有思想的人a. 现代的, 时髦的
music	n. 音乐, 乐曲
daily	a. 每日的, 日常的 adv. 每日地, 日常地n. 日报
ocean	n. 海洋, 广阔, 许多, 一大片[法] 海洋, 海
qualify	vi. 取得资格, 有资格vt. 使有资格, 使合格, 限定, 限制,准予
join	vi. 参加, 结合,加入vt. 连接, 结合,参加, 加入n. 连接, 结合, 接合点[计] 连接; 汇合指令
debate	n. 辩论, 讨论v. 争论, 辩论
modem	n. 调制解调器[计] 调制解调器
strategy	n. 战略, 策略[经] 战略, 策略
sort	n. 种类, 方式, 品质, 态度, 举止 vt. 分类, 排序, 挑选vi. 交往, 协调[计] 排序; DOS外部命令:从标准输入设备接收数据, 整个数据输入完后对它以行为单位进行排序, 然
unique	a. 独一无二的, 独特的, 稀罕的
deal	n. 交易, 协定, 数量, 买卖, 松木板vi. 处理, 应付,做生意vt. 分配, 发牌,给予[计] 发牌
key	n. 钥匙, 键, 解 答, 关键, 要害, 基调, 线索, 答案,暗礁vt. 调音, 锁上,提供线索vi. 使用钥匙 [计] 键, 密钥
exhaust	n. 排气, 排气装置, 废气vt. 抽完, 用尽,耗尽, 使精疲力尽vi. 排气
household	n. 一家人, 家庭,家族, 王室a. 家庭的, 家常的, 王室的
creative	a. 有创造力的, 创作的, 产生的
wrong	a. 错误的, 不正当的, 失常的adv. 错误地
conduct	n. 行为, 举动, 指导vt. 为人, 指挥,管理, 实施vi. 领导, 传导,指挥
size	n. 大小, 尺寸, 规模, 尺码, 能力, 浆料vt. 上浆, 依大小排列vi. 可比拟a. 一定大小的, 一定尺寸的
sick	n. 病人a. 不舒服, 有病的, 恶心的, 厌恶的, 渴望的, 病态的vt. 呕吐, 追击,使(狗)去攻击
stand	n. 站立, 站住, 停顿, 讲台, 看台, 立场, 法院证人席vi. 站, 立, 坐落,停滞, 位于, 坚持,维持原状vt. 忍受, 使站立,抵挡
clearly	adv. 清楚地
criminal	n. 罪犯, 犯人, 刑事a. 犯了罪的, 刑事的, 有罪的
yoga	n. 瑜珈
daughter	n. 女儿a. 女儿的
predict	v. 预知, 预言, 预报
handle	n. 柄, 把手, 把柄, 柄状物, 手感 vt. 触摸, 运用,买卖, 处理, 操作vi. 搬运, 易于操纵n. 句柄[计] 句柄
maintain	vt. 维持, 维修,保持, 坚持, 供养,主张[化] 维修
regard	n. 关心, 注意, 尊敬, 关系, 问候 vt. 视为, 注意, 考虑, 和...有关,看待vi. 注视, 注意
site	n. 位置, 场所, 地点vt. 给...择址
blood	n. 血, 血统, 流血, 气质, 生命 vt. 使出血, 用血涂
asset	n. 资产, 有益的东西
match	n. 比赛, 火柴, 对手vt. 使相配, 使比赛, 与...竞争vi. 结婚, 相配[计] 比较
afford	vt. 买得起, 足以,给予
criticism	n. 批评, 评论, 非难[法] 批判, 批评,评论
general	n. 一般, 将军, 大体a. 全面的, 大体 的, 总的, 一般的,普遍的n. 常规[计] 常规
elderly	a. 过了中年的, 稍老的
relate	vt. 讲, 叙述, 使互相关联vi. 有关, 符合,相处得好
import	n. 进口货, 进口,输入, 含义, 重要性vt. 输入, 引入,进口, 含...的意思, 重要vi. 有关系 [计] 引入
publish	vt. 出版, 发行,公开, 发表, 宣传,公布vi. 出版, 发行
essential	n. 要素, 要点, 本质a. 必要的, 重要的, 本质的[计] 本质冒险
pain	n. 痛苦, 疼痛, 辛苦vt. 使痛苦, 痛苦vi. 作痛, 疼
solution	n. 解决, 解答, 溶液[化] 溶液
recommendation	n. 推荐, 介绍, 推荐信, 劝告[经] 建议书
warn	vt. 警告, 提醒,通知vi. 发出警告
salt	n. 盐, 风趣, 刺激a. 含盐的, 咸的,风趣的, 辛辣的 vt. 加盐于, 用盐腌
communication	n. 交流, 交通, 通讯[计] 通信
divide	vi. 分开, 分配,分裂vt. 分, 分开, 分裂, 除n. 分配, 分水岭 [计] 除
adapt	vt. 使适应, 改编vi. 适应
difficulty	n. 困难, 难点
organization	n. 组织, 结构, 团体, 体制[医] 组织, 机构,机化(血栓或坏死组织)
recall	n. 回忆, 召回, 撤消vt. 回想, 回忆,召回, 撤消, 使恢复[计] 检索
physician	n. 医师, 内科医师, 解除痛苦者 [医] 主治医师
miss	n. 失误, 避免, 失败, 小姐vt. 未得到, 未达到, 未听到, 未觉察, 逃脱, 遗漏,错过, 思念vi. 失败, 击不中
shape	n. 形状, 形态, 外形, 形式, 身材 vt. 定形, 使成形,塑造, 计划, 使符合vi. 成形, 形成,成长[计] 形状
skin	n. 皮肤, 皮vt. 剥皮, 在...植皮vi. 长皮, 愈合,蜕皮
finish	n. 完成, 结束, 末道漆, 磨光, 完美 vt. 完成, 结束, 用完, 毁掉vi. 结束 [计] 完成
lesson	n. 课, 课业, 教训
ingredient	n. 成分, 因素[化] 配合剂; 拼料; 成分; 组分
wireless	n. 无线电a. 无线的, 无线电的
rental	n. 租费, 租金收入a. 租赁的, 收取租金的
weather	n. 天气, 气象, 处境a. 迎风的vt. 使受风吹雨打,侵蚀, 使风化, 经受住vi. 风化, 受侵蚀,经受风雨
fresh	a. 新鲜的, 新奇 的, 另外的, 淡的,精神饱满的, 冒失的adv. 最新地, 刚刚n. 开始, 泛滥
behind	adv. 在后地 prep. 在...背后
lie	n. 谎言, 假象, 位置vi. 躺着, 说谎, 位于, 展现, 存在,停泊vt. 谎骗
attract	vt. 吸引, 诱惑vi. 有吸引力
tall	a. 高的, 长的, 夸大的adv. 夸大地
automate	vt.vi. (使)自动化 [计] 自动化
newspaper	n. 报纸
hit	n. 打击, 打, 冲撞, 讽刺vt. 打, 打击, 碰撞, 打中, 袭击,偶然碰上vi. 打, 打中, 打击, 碰撞, 偶然碰上[计] 击中; 找到;瞬时打扰
motivate	vt. 给与动机, 刺激, 提高...的学习欲望, 促动[经] 促动, 激发,激励
rare	a. 稀罕的, 罕有的, 珍奇的, 稀薄的, 半熟的, 非常好的adv. 非常
cultural	a. 文化的, 教养的, 修养的[医] 培养的
curious	a. 好奇的, 求知的, 古怪的
heat	n. 热, 热度, 体温, 高潮vi. 加热, 激昂,加剧vt. 把...加热, 使激动
vary	vt. 改变, 使多样化vi. 变化, 有不同,违反
chief	n. 领袖, 酋长, 长官, 主要部分a. 主要的, 首位的
throughout	adv. 到处, 贯穿全部地, 自始至终 prep. 遍及, 在各处[计] 吞吐量
introduce	vt. 介绍, 引入,采用, 输入[法] 引进, 输入,介绍
spouse	n. 配偶
library	n. 图书馆, 藏书,库[计] 库
outside	n. 外面, 外表, 外界a. 外面的, 外表的, 外界的adv. 外面, 外表,外界
centre	n. 中心, 中心点,中锋a. 中央的, 位在正中的vt. 集中, 定中心vi. 居中
conflict	n. 战斗, 冲突, 矛盾, 争执vi. 争执, 战斗,冲突, 抵触[计] 冲突
manage	vi. 处理vt. 管理, 控制,维持, 达成, 经营,运用
anyone	pron. 任何人
attitude	n. 态度, 看法, 姿势[医] 体态, 姿势,态度
hardly	adv. 刚刚, 几乎不, 勉强是
regular	a. 规则的, 常例的, 有秩序的, 整齐的, 等边的, 定期的, 经常的, 合格的, 常备军的n. 正规军, 正式队员adv. 经常地n. 正常体[计] 正常体
fuel	n. 燃料, 木炭 vt. 加燃料, 供燃料vi. 得到燃料
land	n. 陆地, 地面, 地界, 地产, 国土, 土地vi. 登陆, 登岸,到达vt. 使上岸, 使登陆, 使到达[计] 连接盘; 焊盘
extremely	adv. 极端地, 非常地
figure	n. 数字, 价格, 图形, 形状vt. 描绘, 表示,演算, 认为vi. 计算, 出现,估计
progress	n. 进步, 发展, 前进vi. 进步, 进行
examine	v. 检查, 调查, 考试
cope	vi. 竞争, 应付n. 长袍
pass	n. 经过, 要隘, 途径, 通行, 护照, 及格vt. 经过, 越过,通过, 批准, 度过,传递, 忽略vi. 经过, 变化, 流通, 及格, 宣判,终止, 消逝, 被忽略, 不叫牌, 传
piece	n. 块, 片, 篇, 碎片, 部分, 部件, 标准量vt. 修补, 修理,拼合, 接线头vi. 吃零食
interview	n. 面谈, 访问, 接见, 面试vt. 接见, 对...进行面谈(试)
critic	n. 批评家, 鉴定家
portion	n. 部分, 一份, 命运, 嫁妆vt. 分配, 给...嫁妆
critical	a. 批评的, 决定性的, 危险的, 临界的[医] 危象的; 临界的, 极期的
beer	n. 啤酒[化] 啤酒
feature	n. 面孔的一部分 (如眼、口等), 特征, 容貌, 特色,特写vt. 是...的特色,特写, 放映vi. 起重要作用 [计] 特性
post	n. 柱, 杆, 准星,邮件, 邮政, 标竿,职位, 岗位, 哨所,兵营vt. 张帖, 邮递,公布, 登入帐, 使熟悉, 布置vi. 快速行进 adv. 急速地[计] 记入; 登记,上
indicate	vt. 显示, 象征,指示, 指出[医] 指示
yield	n. 生产量, 投资收益vt. 出产, 给予,让出, 放弃, 使屈服vi. 出产, 屈服,投降, 倒塌
tobacco	n. 烟草, 香烟 [医] 烟草
thousand	num. 千a. 成千的, 许多的n. 许许多多
productive	a. 能生产的, 有生产价值的, 多产的 [医] 产出性的, 产生性的
chemical	n. 化学药品a. 化学的, 化学上用的
window	n. 窗户, 窗子, 窗口vt. 给...开窗 [计] 窗口
homework	n. 家庭作业, 家里做的工作[经] 家庭作业
police	n. 警察, 警察当局, 治安vt. 维持治安, 管辖
section	n. 区段, 部分, 区域, 节, 截面, 处,科, 区, 扇区vt. 把...分段,把...切片vi. 被切成片[计] 扇区
maker	n. 制造者, 上帝[经] 制造者, 出票人
cancer	n. 癌, 恶性肿瘤 [医] 癌
emotional	a. 情绪的, 情感的 [医] 情绪的
greatly	adv. 很, 非常
compete	vi. 竞争, 对抗
date	n. 日期, 约会, 枣椰树vt. 约会, 定日期vi. 注明日期, 过时
wake	vt. 叫醒, 激发vi. 醒来, 醒着,觉醒, 活跃起来n. 守侯, 守夜, 尾迹, 痕迹
neighborhood	n. 附近, 邻近
hate	n. 憎恨, 恨, 厌恶 vt. 憎恨, 憎恶vi. 仇恨
harm	n. 伤害, 害处 vt. 伤害, 损害
ignore	vt. 不理睬, 忽视,驳回, 忽略[计] 忽略
peer	n. 同等的人, 匹敌, 贵族vi. 凝视, 窥视, 费力地看, 隐现 vt. 与...同等, 封为贵族
principle	n. 原则, 原理, 主义[化] 原理
push	n. 推, 推动, 奋 斗, 攻击, 进取心 vt. 推, 推动, 使伸出, 推行, 逼迫,增加vi. 推, 推进, 增加, 努力争取
paint	n. 油漆, 颜料, 绘画作品, 涂漆vt. 油漆, 绘, 画,描绘, 装饰, 点缀vi. 绘画, 涂漆
pursue	vt. 追赶, 追踪,追随, 追求, 实行,继续, 从事vi. 追赶, 继续
toward	prep. 向, 对于,为了a. 即将来临的, 进行中的
third	num. 第三, 三分之一[机] 第三; 第三的
combine	v. (使)联合, (使)结合n. (企业的)联合,联合收割机
rent	n. 租金, 房租, 出租物, 裂缝, 破裂处, 分裂vt. 租用, 租出vi. 出租a. 分裂的, 破裂的 rend的过去式和过去分词
behavior	n. 行为, 举止 [医] 行为
assist	n. 帮助, 协助 vt. 帮助, 促进vi. 协助, 参加
prize	n. 奖赏, 奖金, 奖品, 战利品, 捕获a. 得奖的vt. 珍视, 估价,捕获, 撬, 撬动
employer	n. 雇主, 老板[经] 雇主, 业主
relatively	adv. 相对地, 比较地, 相当地, 相关地[计] 相对地
exactly	adv. 确切地, 精确地, 恰好, 完全地,确实, 恰恰正是, 确实如此
international	a. 国际的n. 国别设定[计] 国别设定
tradition	n. 传说, 传统, 交付[法] 传统, 惯例,移交
object	n. 物体, 目标, 目的, 对象, 宾语, 客体vi. 反对, 抱反感 vt. 提出...来反对 [计] 对象
guest	n. 客人, 来宾, 旅客[化] 客体
document	n. 文件, 公文, 文档vt. 证明, 为...引证[计] 文档
inside	n. 内部, 内脏, 内幕a. 内部的, 秘密的, 户内的adv. 在里面 prep. 在...之内
senior	n. 年长者, 资深者, 毕业班学生a. 年长的, 高级的, 资深的
educator	n. 教育家
cognitive	a. 认知的, 认识的
suppose	vt. 推想, 假设,以为, 想像, 假定vi. 料想
delay	n. 耽搁, 迟滞v. 耽搁, 延迟[计] 延迟, 延时
widely	adv. 广泛地
reverse	n. 相反, 背面, 倒退, 挫折, 失败a. 反面的, 相反的, 反向的, 颠倒的vt. 使颠倒, 使逆转, 使倒退, 使反向vi. 倒退, 反向,倒转, 反转[计] 反转
weekend	n. 周末, 周末休假
content	n. 内容, 满足, 意义, 要旨a. 满足的, 满意的 vt. 使...满足,  使...安心[计] 内容
responsible	a. 有责任的, 负责的, 责任重大的[法] 应负责任的,有责任的, 能履行责任的
describe	vt. 描述, 描绘,画
reflect	vt. 反射, 反映,招致, 深思vi. 被反射, 映出,深思, 考虑, 指责
urban	a. 都市的, 住在都市的, 习惯于都市的[法] 城市的, 都市的, 市区的
practical	a. 实际的, 现实的, 实用性的[法] 事实上的, 实际上的, 接近...的
alarm	n. 惊恐, 警报, 警钟vt. 使惊恐, 警告[计] 报警信号
suspect	n. 被怀疑者, 嫌疑犯a. 令人怀疑的, 不可信的, 可疑的v. 怀疑, 猜想
capacity	n. 容量, 能力, 才能, 资格[计] 容量
express	n. 快车, 快递, 专使a. 明确的, 丝毫不差的, 专门的, 快的vt. 表达, 表示,表露
scientific	a. 科学的, 系统的, 符合科学规律的[计] 科学记数法
perform	vt. 进行, 履行,完成, 执行, 表演vi. 行动, 工作,执行, 演出
television	n. 电视[电] 电视
generate	vt. 产生, 发生,导致[电] 产生
failure	n. 失败, 失败者,不足, 缺乏, 破产 [计] 故障; 失效
hundred	n. 百, 百个东西 num. 百, 百个a. 一百的, 许多的
snack	n. 小吃, 点心, 快餐vi. 吃零食, 吃快餐
launch	n. 下水, 汽艇, 发射vt. 使下水, 发射,发动vi. 起飞, 下水,投入, 开始
dish	n. 盘子, 碟, 菜肴 [医] 皿, 碟
enhance	vt. 提高, 加强,增加
military	n. 军队a. 军事的, 军人的, 适于战争的
heavily	adv. 很重地, 严重地, 难以忍受地
gather	n. 集合, 聚集vi. 聚集, 集合,渐增vt. 使聚集, 搜集,积聚
worldwide	a. 全世界的
wind	n. 风, 气息, 气 味, 呼吸, 风声, 趋势, 空谈, 卷绕,弯曲vt. 使通风, 嗅出,使喘气, 吹号角, 上发条, 缠绕, 包,绞起, 吊起, 使弯曲, 使迂回vi. 嗅出猎物, 吹
crowd	n. 群众, 一伙人 vt. 拥挤, 挤满,挤进
invite	vt. 邀请, 请求,引起, 招致n. 邀请
counterpart	n. 副本, 复本, 配对物, 相应物[经] 副本, 正副二份中之一
depress	vt. 使沮丧, 压低,降低, 使萧条[化] 推下
cold	n. 感冒, 寒冷a. 寒冷的, 冷淡的, 冷静的adv. 完全地
implication	n. 牵连, 含义, 暗示[法] 推断, 含蓄之意, 暗示
adopt	vt. 采用, 正式通过, 收养, 接受[医] 采取
well-being	a. 安宁的, 康乐的
relative	n. 亲戚, 关系词a. 有关系的, 相对的, 比较的
meaningful	a. 意味深长的
fill	vt. 装满, 填充,弥漫, 供给, 满足,供应vi. 充满, 变得沉重n. 满足, 装满, 充分, 填方vt. 填充vi. 填充 [计] 填充
husband	n. 丈夫, 管理人,节俭的人vt. 节俭, 使成丈夫, 持有
willing	a. 乐意的, 自愿的, 甘愿的
labor	n. 劳动, 努力, 工作, 劳工, 分娩vi. 劳动, 努力,苦干vt. 详细分析, 使厌烦
wide	a. 宽的, 广阔的,普遍的, 宽阔的, 广泛的, 一般的 adv. 广阔地, 遍及各处地, 广泛地n. 大千世界
apartment	n. 房间, 公寓
foot	n. 脚, 步调, 英尺, 底部, 末尾,步兵vt. 走在...上,给...换底, 支付vi. 跳舞, 步行,总计
achievement	n. 完成, 成就, 功业
tourism	n. 观光业, 游览 [经] 旅游业
determine	v. 决定, 决心
gradually	adv. 逐渐地
front	n. 前面, 开头, 前线, 阵线, 态度 vt. 面对, 朝向, 对抗vi. 朝向
chain	n. 链, 枷锁, 束缚 vt. 用铁练锁住, 束缚, 囚禁
kill	n. 杀, 杀戮, 小河 vt. 杀, 破坏, 消灭, 使终止, 抵消,否决vi. 杀死 [计] 删除
double	n. 两倍a. 两倍的, 双重的 vt. 使加倍vi. 加倍, 代替,快步走[计] 双精度型
political	a. 政治的, 政治上的, 政党的, 从事政治的[法] 政治的, 政治上的, 党派政治的
foreign	a. 外国的, 外交的, 外省的, 外来的, 不相关的[机] 外来的
perfect	n. 完成时a. 完美的, 完好的, 理想的, 熟练的, 精确的, 完成式的vt. 使完美, 修改,使精通, 改善, 使熟练
creation	n. 创造, 创作物,发明[化] 产生
wear	n. 穿着, 戴, 使用, 耗损, 服装,耐久性vt. 穿着, 戴, 留(须、发等), 呈现,磨损, 磨成, 耗损,使疲乏, 消磨vi. 磨损, 变旧,耐久, 渐变, 渐渐消失
ban	n. 禁令vt. 禁止, 取缔
extra	n. 额外的事物, 另外的收费a. 额外的, 特别的 adv. 额外地, 特别地, 非常地
succeed	vi. 成功, 继承,继续vt. 继承, 接替
creativity	n. 创造力, 创造性
suggestion	n. 提议, 意见 [医] 暗示
advantage	n. 优点, 便利, 好处, 优势vt. 有助于
struggle	n. 斗争, 努力, 奋斗vi. 努力, 奋斗,挣扎
investor	n. 投资者[经] 投资者
wife	n. 妻子, 太太, 夫人[法] 妻子, 已婚妇女
powerful	a. 有力的, 有权力的, 强大的[机] 强力的
press	n. 压, 揿, 按, 人群, 印刷机, 压力,出版社, 记者, 报刊, 新闻舆论, 紧迫vt. 压, 压榨, 紧抱, 逼迫, 推进,强迫征募, 催逼vi. 压, 重压, 催促, 拥挤, 奋力
domestic	a. 家庭的, 国内的, 驯养的[医] 家庭的, 家用的
commit	vt. 委托(托付),犯罪, 指派...作战, 使承担义务 [法] 犯, 做,把...交托给
transportation	n. 运输, 输送, 交通车辆[经] 运转, 运输,运输费
total	a. 全体的, 总的,全然的vt. 计算...的总和, 共计为vi. 合计n. 总数, 全体, 合计adv. 统统
feedback	n. 反馈, 反应 [计] 反馈
fully	adv. 十分地, 完全地, 充分地
intake	n. 入口, 吸入, 吸入量[医] 摄取量
ten	num. 十, 十个
separate	n. 独立件, 抽印本a. 分开的, 各别的, 单独的, 分隔的vi. 分开, 隔开,分居vt. 使分离, 使分开, 区分, 使分居
excellent	a. 优良的, 杰出的, 出色的
everywhere	adv. 各处, 到处
screen	n. 幕, 银幕, 屏 风, 掩蔽物, 屏蔽,筛子vt. 掩蔽, 放映,拍摄, 掩护, 筛,甄别vi. 拍电影[计] 筛选; 屏幕
simple	a. 简单的, 普通的, 朴素的, 单纯的, 绝对的, 初级的, 原始的, 迟钝的n. 出身低微者, 傻子
primary	n. 最主要者, 原色a. 主要的, 初期的, 根本的, 原始的, 首要的, 基本的[计] 初等量; 主要的; 一次的
valuable	a. 有价值的, 贵重的, 宝贵的, 可估价的[经] 有价值的, 可估价的, 贵重的
shed	n. 车棚, 小屋, 脱落之物, 分水岭 vt. 使流出, 放射,脱落, 散发, 摆脱vi. 流出, 散布,脱落
director	n. 主管, 导演, 董事[计] 寻向偶极子;指挥仪
own	n. 自己的a. 自己的, 嫡亲的, 同胞的vt. 拥有, 支配,自认, 承认, 顺从于vi. 承认, 供认
familiar	a. 熟悉的, 常见的, 亲密的n. 熟友, 常客
mobile	a. 移动的, 易变的, 机动的n. 活动物体
chef	n. 厨师
strength	n. 力量, 实力, 强度, 浓度, 人数, 抵抗力[化] 强度
entertainment	n. 娱乐, 款待, 娱乐表演
central	a. 中央的, 重要的 [医] 中央的, 中心的, 中枢的
package	n. 包裹, 套装软 件, 包, 包装用物,程序包vt. 包装, 打包a. 一揽子的[计] 包, 软件包,包装
cash	n. 现金 vt. 兑现
liberal	n. 自由主义者a. 慷慨的, 不拘泥的, 宽大的, 自由主义的
wonder	n. 奇迹, 惊奇, 惊愕vt. 惊奇, 想知道vi. 惊讶, 怀疑
being	n. 存在, 性质, 生命, 人, 生物, be的现在分词
studio	n. 工作室, 画室,演播室, 电影制片厂
junk	n. 垃圾, 乌七八糟的东西, 舢板[计] 清除
nicotine	n. 烟碱, 尼古丁[化] 烟碱; 尼古丁
wash	n. 洗, 洗涤, 冲洗, 洗的衣服, 冲积物, 洼地vt. 洗, 洗涤, 洗清, 用水冲洗, 流过, 弄湿, 粉刷,镀金属薄层于vi. 洗涤, 洗澡,被冲蚀, 漂浮
aim	n. 目标, 瞄准, 击中目标的能力vi. 对准目标, 致力, 打算vt. 瞄准[计] 医学文摘索 引, 存取隔离机构,高级信息管理程序,先进接口模块应用接口模块, 医学人工智能, 相联索引
board	n. 木板, 甲板, 膳食, 会议桌vt. 乘船, 供膳食,用板覆盖vi. 搭伙 [计] 板
curriculum	n. 课程[医] 课程, 学程
budget	n. 预算vi. 编预算vt. 编入预算, 安排a. 廉价的
street	n. 街道, 马路, 街区a. 街道的
unable	a. 不能的, 不会的 [法] 无能力的, 无资格的, 没有办法的
conversation	n. 会话, 说话, 交谈[法] 交谈, 社交,性交
vegetable	n. 蔬菜, 植物, 无精打采之人a. 蔬菜的, 植物的
arrangement	n. 排列, 整齐, 安排[计] 排列
harmful	a. 有害的, 伤害的
spread	n. 传播, 散布, 伸展a. 双唇展开的, 伸展的vt. 展开, 铺开,传播, 推广, 伸出,涂, 敷, 延伸vi. 展开, 扩大,传开, 延伸[计] 展开
closely	adv. 接近地
promotion	n. 晋级, 创建, 增进[经] 推广, 推销,促进
repair	n. 修理, 补救, 修复vt. 修理, 修补,补救, 恢复, 补偿vi. 修理, 修补,补救, 恢复, 去,常去, 集合
longevity	n. 长命, 长寿, 寿命[医] 长寿
wall	n. 墙, 墙壁, 垣,内壁, 分界物, 屏障a. 墙的vt. 给...建墙, 禁闭, 用墙围住[计] 背景墙
retire	n. 隐居vi. 引退, 退役, 退休, 退去, 撤退,退却vt. 使...撤退, 辞退
extend	v. 扩充, 延伸, 伸展, 扩大[计] 扩展
communicate	vt. 显露, 传达,感染vi. 通讯
danger	n. 危险, 威胁[法] 危险, 危险物, 危机
feeling	n. 摸, 触觉, 知觉, 感觉, 情绪,同情a. 有同情心的, 有感觉的, 仁慈的, 动人的
complain	v. 抱怨, 抗议, 控诉
contaminate	vt. 弄污, 弄脏,污染, 毒害[化] 污染
ultimately	adv. 最后, 最终 [法] 最后, 终究,总之
childhood	n. 孩童时期 [医] 儿童期
enter	vt. 进入, 参加,开始, 输入, 回车vi. 进去, 参加 [计] 输入, 回车
respect	n. 尊敬, 尊重, 问候vt. 尊敬, 注意,遵守
twice	adv. 两次, 两倍
prospect	n. 景色, 展望 vt. 勘探, 勘察vi. 勘探, 有前途
per	prep. 每一, 通过,经, 按照[经] 每, 按照
entire	n. 整个, 全部a. 全体的, 完全的, 全部的
catch	n. 捕捉, 陷阱, 捕捉之物, 抓, 拉手 vt. 捕捉, 赶上, 感染, 听清楚vi. 抓住, 燃着
ticket	n. 票, 券, 车票,标签, 入场券, 证明书vt. 加标签于,为...购票
release	n. 释放, 发泄, 豁免, 发行, 释放证书vt. 释放, 解除,放松, 豁免, 免除,发布, 放弃, 让与n. 发布[计] 版本, 发布
collect	v. 收集, 聚集, 集中, 搜集a. 由收到者付款的 adv. 由收到者付款地
airport	n. 飞机场[机] 航空站, 机场
sentence	n. 句子, 命题, 宣判vt. 宣判, 判决 [计] 句子
organize	vt. 组织, 有机化,给予生机vi. 组织起来
holiday	n. 假日, 假期, 节日vi. 度假
finance	n. 财政, 财务 vt. 供给...经费,负担经费vi. 筹措资金
award	n. 奖品, 裁定, 判决vt. 授予, 给予
table	n. 桌子, 餐桌, 工作台, 铭文, 表格,表, 高原, 平地层 vt. 搁置, 嵌合, 制表, 把...列入议事日程[计] 表格, 模拟运算表
theory	n. 理论, 学说, 原理, 意见, 推测[化] 理论
please	adv. 请vt. 使高兴, 合...的心意, 取悦vi. 使人满意, 讨好, 愿意, 敬请
importance	n. 重要, 重要性,重要地位, 自大[机] 重要, 重要性
signal	n. 信号, 暗号, 近因, 导火线vt. 向...作信号,标志, 用信号通知vi. 发信号a. 作为信号的, 显著的[计] 信号
shake	n. 摇动, 震动 vt. 摇动, 动摇,使震动, 挥舞vi. 震动, 发抖,动摇
crop	n. 农作物, 产量,平头vt. 收割, 修剪,种植vi. 收获 [计] 裁剪
exploration	n. 探险, 踏勘, 探测[医] 探察
temperature	n. 温度, 发烧, 热度[化] 温度
fun	n. 乐趣, 玩笑, 娱乐vi. 开玩笑a. 供娱乐用的
black	n. 黑色, 黑颜料a. 黑色的
waste	n. 浪费, 废物, 损耗, 消耗, 荒地, 垃圾, 地面风化物a. 废弃的, 荒芜的, 多余的vt. 浪费, 消耗,使荒芜vi. 浪费, 消耗,变消瘦
remove	vt. 移动, 调动,除去, 迁移, 开除,移交vi. 迁移, 移动,搬家n. 班级, 升级, 移动, 搬家, 间距[计] 删除
complicate	vt. 弄复杂, 使错综, 使恶化vi. 变复杂
threat	n. 恐吓, 恶兆, 威胁[经] 威胁
completely	adv. 完全地, 十分地, 圆满地
sun	n. 太阳, 日, 日光, 阳光vt. 晒vi. 晒太阳
recognize	vt. 认出, 认可,承认, 公认, 识别,赏识vi. 承认, 具结
forward	a. 向前的, 早的,迅速的, 在前的,进步的vt. 促进...的生长, 转寄, 运送 adv. 向前地[计] 前推, 转信
paragraph	n. 段落, 短评vt. 将...分段, 分段落vi. 写短讯 [计] 段落
bill	n. 帐单, 清单, 钞票, 鸟嘴, 广告, 法案, 票据vt. 开帐单, (用招贴)宣布
establish	vt. 建立, 确立,制定vi. 移植生长
acquire	vt. 获得, 学到 [电] 目标锁定
argument	n. 争论, 论证, 论据, 自变量[计] 参数
strange	a. 奇怪的, 陌生 的, 生疏的, 不熟悉的, 不可思议的,外行的, 外地的, 异乡的
block	n. 街区, 木块, 石块, 块vt. 阻塞, 封锁,使成块状[计] 块, 数据块
immediately	adv. 直接地, 立刻, 立即
infant	n. 婴儿, 儿童, 初学者a. 婴儿的, 幼稚的
evolve	vi. 进展, 进化,展开vt. 使发展, 使推断出, 使进化
assign	vt. 分配, 指派,赋值[计] 赋值
emerge	vi. 浮现, 形成,出现, (事实)显露
addition	n. 加法, 增加的人 (或物)[计] 加法
gesture	n. 手势, 姿态vi. 作手势, 作姿态
derive	vt. 得自vi. 起源
hinder	a. 后面的v. 阻碍, 打扰
comet	n. 彗星
door	n. 门
nature	n. 自然, 大自然,本性, 性格, 性质 [医] 自然, 大自然; 本性, 性能
morning	n. 早晨, 早上, 初期
panel	n. 嵌板, 仪表板,专题讨论小组, 全体陪审员vt. 嵌镶板
artist	n. 艺术家, 画家
instruction	n. 指令, 教导, 命令[计] 指令
odd	a. 奇数的, 古怪的, 剩余的, 零散的, 各种各样的,少量的n. 奇特的事物, 怪人[计] 奇数, 奇校验, 光数据数字转换器
differ	vi. 不一致, 不同 [机] 差异, 不同
guide	n. 引导者, 导游,指南, 路标vt. 指导, 支配,管理, 带领, 操纵vi. 任向导 [计] 辅助线
user	n. 使用者 [计] 用户
island	n. 岛, 岛屿, 孤立地区, 安全岛vt. 使成岛状, 孤立
regularly	adv. 有规则地, 一丝不苟地, 正式地
listen	vi. 听, 倾听, 听从n. 听, 倾听
unusual	a. 不寻常的, 罕见的, 与众不同的
boy	n. 男孩[法] 男孩, 少年,儿子
burden	n. 负担, 重载, 担子, 责任vt. 装货于, 烦扰,使负担
link	n. 环, 连结物, 链接, 火把vt. 连结, 联合,挽住vi. 连接起来[计] 连接, 链路
dollar	n. 美元, 元(加、澳等国货币单位)[经] 纯经济的, 美元, 元
bird	n. 鸟, 羽毛球vi. 打鸟
hunt	n. 狩猎, 追捕, 搜寻, 猎区vt. 狩猎, 打猎,搜索vi. 打猎, 猎食,搜寻
respond	vt. 以...回答vi. 回答, 响应,回报, 有反应, 承担责任
shelf	n. 架子, 搁板 [化] 架子
reveal	vt. 露出, 显示,透露, 揭露, 泄露, (神)启示n. 窗侧, 门侧
monitor	n. 监督器, 级长,监听员, 班长, 监视器, 告诫物v. 监视, 监听, 监督[计] 监视器, 监视程序; 监视
weight	n. 重, 重量, 体重, 砝码, 重大,影响, 力量vt. 加重量于, 压迫, 使加权, 称重量[计] 粗细
destroy	vt. 破坏, 毁坏,消灭
waiter	n. 侍者
advocate	n. 提倡者, 拥护者 vt. 主张, 提倡
farm	n. 农场, 农田 vt. 耕种vi. 种田
prison	n. 监狱, 监禁, 拘留所vt. 监禁
pump	n. 抽水机, 打气筒, 泵, 抽吸 vt. 用唧筒抽水,打气, 盘问, 倾注,使疲惫vi. 抽水, 上下(或往复)运动
honor	n. 荣誉, 头衔, 信用, 尊敬, 名誉, 阁下, 勋章vt. 尊敬, 授予荣誉, 承兑, 实践
transfer	n. 迁移, 移动, 传递, 转让, 转移, 过户, 汇兑, 换车 vt. 使转移, 调转,调任, 改变, 传递,转让vi. 转移, 转学,转职, 换车[计] 传送
dinner	n. 晚餐, 正餐, 宴会
crime	n. 犯罪, 罪行, 罪恶[法] 犯罪, 罪, 罪恶
profitable	a. 有利润的, 有利益的, 赚钱的[经] 有利(可图)的, 合算的
sad	a. 忧愁的, 悲哀的
elsewhere	adv. 在别处
outcome	n. 结果, 出口
win	vt. 赢得, 打胜,成功vi. 获胜, 达到,影响n. 胜利, 赢, 收益
finger	n. 手指, 指状物, (手套的)手指部分,指针v. 用手指拨弄, 伸出[计] 网络命令
whose	pron. 谁的
deliver	vt. 递送, 陈述,释放, 发表, 引渡,投递, 交付[经] 交运
overseas	a. 海外的, 国外的 adv. 在海外, 在国外
colleague	n. 同事, 同僚
alternative	n. 两者择一, 供替代的选择a. 两者择一的, 供选择的[计] 选择对象
assessment	n. 评估, 估定, 评定的款额[化] 评估
emotion	n. 情绪, 激动, 强烈的情感[医] 情绪, 情感
whatever	pron. 无论什么
equal	n. 对手, 匹敌, 同辈a. 相等的, 平等的, 胜任的, 合适的, 平静的, 不相上下的vt. 等于, 比得上 [计] 等长度编码
refer	vt. 提交, 归诸于,把...提交, 使求助于vi. 提到, 涉及,查阅, 查询, 咨询
lecture	n. 演讲, 谴责, 讲稿vt. 演讲, 训诫,说教vi. 讲演
competitive	a. 竞争的[经] 竞争的
administrator	n. 管理人, 行政官 [经] 遗产管理人员
confuse	vt. 使混乱, 使狼狈, 使困惑[法] 混淆
clock	n. 时钟, 计时器, (袜子上的)绣花边花vt. 绣花样, 记时,记录vi. 记录时间[计] 时钟
box	n. 盒子, 箱, 方框, 一巴掌vt. 装...入盒中,装箱, 打耳光vi. 拳击 [计] 方框
label	n. 标签, 称号, 商标, 标志vt. 贴标签于, 标注[计] 标志; 标注; DOS外部命令:用于建立改变或删除磁盘卷标号
spare	n. 剩余, 备用品,备件, 备用零件,备用轮胎a. 多余的, 备用的, 空闲的, 节约的, 瘦的vi. 节约, 省掉,宽恕vt. 节约, 省用,剩下, 饶恕, 赦免
transaction	n. 交易, 办理, 学报, 和解协议[计] 事务处理
beautiful	a. 美丽的
structure	n. 结构, 构造, 建筑物vt. 构成, 组织
track	n. 轨迹, 足迹, 径迹, 小道, 轨道, 磁轨, 途径vt. 循路而行, 追踪, 通过, 用纤拉vi. 追踪, 留下足迹, 沿轨道运行[计] 跟踪
legal	a. 法律的, 法定的, 合法的[经] 法定权利; 法律(上)的, 合法的
comfortable	a. 舒服的, 轻松的n. 盖被
detect	vt. 发现, 察觉,探测[法] 发现, 查明,探测
plant	n. 植物, 作物, 工厂, 树枝, 生长, 设施, 成套设备 vt. 种植, 栽培, 播种, 培养, 安置,殖民于, 使位于vi. 种植
lifetime	n. 一生, 终生a. 一生的, 终生的
steal	vt. 剽窃；偷偷地做；偷窃；vi. 窃取；偷偷地行动； [棒球]偷垒；n.[口]偷窃；便宜 货；偷垒；[篮球]断球
efficiency	n. 效率, 效能, 功效[医] 效率, 效力
percentage	n. 百分比, 比率,部分, 可能性[计] 百分比
happiness	n. 快乐, 幸运, 适当
pretty	a. 漂亮的, 优美的, 机灵的, 狡猾的, 恰当的adv. 相当, 颇
federal	a. 联邦的, 联合的, 同盟的[法] 联邦的, 联邦制的, 联盟的
update	vt. 更新, 使现代化n. 更新[计] 更新
stuff	n. 原料, 要素, 东西, 材料, 素质, 织品, 废物, 废话 vt. 装填vi. 狼吞虎咽
ease	n. 安乐, 安逸, 悠闲vt. 使安乐, 使安心, 减轻, 放松vi. 减轻, 放松,灵活地移动
quick	a. 快的, 迅速的,敏捷的, 灵敏的,急速的adv. 快n. 新长出的肉, 要害, 核心, 感觉敏锐部位
heavy	a. 重的, 巨大的,沉重的, 笨重的,过度的adv. 沉重地n. 重物, 严肃角色
inform	vt. 通知, 使了解,使充满vi. 提供资料, 告发
alert	a. 警觉的, 灵敏的, 留心的n. 警报vt. 使警觉, 通知,使意识到
excite	vt. 刺激, 使兴奋,激励
popularity	n. 名声, 受大众欢迎, 流行
spring	n. 春天, 弹簧, 跳跃, 弹性, 活力, 泉, 源泉a. 春天的vi. 跳, 弹跳, 涌出, 生长, 裂开,高耸vt. 使跳起, 使爆炸, 突然提出
ahead	a. 领先的, 预先的, 向前的adv. 领先, 预先,向前, 胜于, 在前面, 在将来
mainly	adv. 主要地, 大抵
treatment	n. 治疗, 待遇, 处理[医] 疗法, 治疗;处理
freeze	vi. 冻结, 冷冻,僵硬, 楞住vt. 使结冰, 使冻住, 使呆住n. 结冰, 凝固 [计] 冻结
electronic	a. 电子的[计] 电子工业协会接口
birthday	n. 生日
productivity	n. 生产力[经] 生产率, 生产能力
agency	n. 代理机构, 经销商, 中介[化] 办事处
menu	n. 菜单, (功能)选择单[计] 菜单
prompt	n. 激励, 提示, 提醒物, 提词, 付款期限a. 迅速的, 敏捷的, 立刻的, 提词员的vt. 激励, 鼓动,提示adv. 准时地[计] 提示符; DOS内部命令:设定DOS命令行的提示
juice	n. 汁, 活力, 体液 vt. 挤出汁来, 加汁
error	n. 错误, 过失, 失误, 误差[计] 错误
girl	n. 女孩, 少女, 女佣
severe	a. 严格的, 尖锐的, 严肃的, 严重的, 严厉的, 朴素的[法] 严厉的, 苛刻的, 严重的
highlight	n. 加亮区, 精彩场面vt. 加亮, 使显著,以强光照射, 突出[计] 突出
blame	n. 过失, 责备 vt. 责备, 归咎于
applicant	n. 申请者[经] 申请人, 请求人, 谋事人
star	n. 星, 恒星, 星形物, 运气, 明星 vt. 以星状物装饰,用星号标, 使成为明星vi. 变成明星
campus	n. 校园, 大学生活
therefore	adv. 因此, 所以
vast	a. 巨大的, 广大的, 非常的, 大量的
adulthood	n. 成年[医] 成人期
primarily	adv. 主要地, 首先地
acknowledge	vt. 承认, 告知收悉, 答谢, 报偿[经] 承认, 答谢,收到的通知
accept	vt. 接受, 承认,同意, 相信, 赞成,承担, 承兑, 采纳,接纳, 容忍vi. 同意
puzzle	n. 难题, 迷惑 vt. 使困惑, 使为难vi. 迷惑, 苦思
president	n. 总统, 总裁, 董事长, (学院)院长, (大学)校长, 主管人, 主持人[经] 总经理, 董事长, 总裁
sweet	n. 甜蜜, 糖果, 情人a. 甜的, 芳香的,悦耳的, 漂亮的,和蔼的, 不咸的,灵活的, 轻快的
swim	n. 游泳, 漂浮, 潮流, 眩晕vi. 游泳, 游, 漂浮, 浸, 覆盖, 充溢, 大量拥有, 旋转, 眩晕vt. 游过, 使浮起
revolution	n. 革命, 大变革,旋转, 转数, 循环 [化] 回转
preparation	n. 准备, 预备, 预习[化] 制剂
mix	n. 混合物, 混乱,糊涂vt. 使混合, 弄混,使结合, 混淆vi. 相混合, 交往,参与
weak	a. 不牢固的, 弱的, 虚弱的, 软弱的, 无力的, 无权力的, (论据等)不充分的[经] 疲软的
distinguish	v. 区别, 辨别
frequently	adv. 频繁, 经常地
survive	vt. 比...活得长,生存, 生还, 幸免于vi. 活下来, 幸存
judge	n. 法官, 裁判员,审判官, 鉴定人 vt. 审理, 鉴定,判断, 判决, 裁定vi. 下判断, 作评价
largely	adv. 大量地, 很多地, 大半地
revenue	n. 收入, 岁入, 税收, 税务局[经] 岁入, 税收,税务局
wish	n. 希望, 愿望, 祝愿, 命令, 请求 vt. 愿, 想要, 希望, 祝愿vi. 希望
stunt	n. 特技, 绝技, 花招, 噱头, 手腕, 发育不良vt. 阻碍成长vi. 表演特技
seriously	adv. 严肃地, 认真地, 严重地
translate	vt. 翻译, 解释,转化, 转变为, 调动vi. 翻译, 被译 [计] 转换
official	n. 官员, 公务员,职员a. 公务的, 官方的, 正式的
plane	n. 平面, 扁平物,机翼, 飞机, 水准,地位a. 平的, 平面的 vt. 将...刨平, 刨平, 掠过水面vi. 翱翔, 乘飞机旅行, 刨掉
period	n. 时期, 节段,节, 句点, 学时,周期a. 当时特有的, 过去某段时期的 interj. 就是这话,就是这么回事
wage	n. 工资, 报应, 报偿vt. 开展, 进行vi. 进行
possibility	n. 可能性, 可能的事[法] 可能性, 可能发生的事, 不确定权
chess	n. 国际象棋 [建] 雀麦
tutor	n. 家庭教师, 导师, 助教, 监护人 vt. 当...的教师,教, 指导, 约束,克制vi. 当家庭教师,受家庭教师的指导
conventional	a. 传统的, 习惯的, 约定的[经] 惯例的, 常规的, 传统的
upon	prep. 在...之上,迫近, 紧接着
stimulate	vt. 刺激, 激励,鼓舞vi. 起刺激作用
path	n. 路径, 小路, 道路, 途径, 路线, 轨道[计] 路径; DOS内部命令:设定DOS读取程序的路径
aspect	n. 外观, 方面, 面貌, 方向[医] 方面, 局面;外观
plenty	n. 充分, 很多, 丰富a. 很多的, 足够的, 丰富的
biological	a. 生物学的[医] 生物学的
parental	a. 父母亲的, 做双亲的, 作为渊源的 [医] 父母的, 双亲的
sea	n. 海, 海洋, 海浪, 大量[法] 海, 海洋
currently	adv. 现在, 当前,一般, 普通[计] 当前
economist	n. 经济学者, 经济家[经] 经济学家
satisfy	vt. 使满意, 满足,符合, 使确信, 赔偿vi. 令人满意, 替人赎罪
diabetes	n. 糖尿病, 多尿症 [医] 糖尿病; 多尿症
certainly	adv. 确定地
photo	n. 相片, 照片, 逼真的描绘v. 照相a. 照相的, 摄影用的, 详细记录的, 逼真的, 酷似的
background	n. 背景, 背景资料 [计] 背景, 后台
commercial	a. 商业的, 商用的, 商品化的n. 商业广告节目
full-time	a. 全部时间的, 专任的
vulnerable	a. 易受伤害的, 有弱点的, 易受影响的, 脆弱的, 成局的[医] 易损的
priority	n. 优先权, 优先 [计] 优先级
twenty	num. 二十, 二十个
building	n. 建筑物, 建筑 [法] 营造, 建筑,建筑物
extension	n. 延长, 扩充, 范围, 扩展名a. 伸缩的[计] 扩展名, 扩充名
psychological	a. 心理学的, 精神上的, 心灵的[法] 心理上的, 心理学的
former	a. 从前的, 前者的n. 起形成作用的人 (或物), 模型, 样板
admit	vt. 承认, 接受,允许进入, 容许vi. 开向, 容许,承认
internet	[计] 因特网, 国际互连网, 网际网络,互连网络, 广域网
radio	n. 无线电, 收音机, 无线电报, 无线电广播, 无线电台v. 用无线电发送
novel	n. 小说, 长篇故事a. 新奇的, 异常的
rid	vt. 免除, 以...清除, 使获自由, 使摆脱[法] 免除, 清除,摆脱
drug	n. 药, 麻药, 麻醉药vi. 吸毒vt. 使服麻醉药,使麻木
rapid	a. 迅速的, 飞快的, 急促的, 陡的n. 急流
opposite	a. 相对的, 相反的, 对面的 prep. 对面n. 对立面
strike	n. 罢工, 打击, 殴打vt. 打, 撞击, 冲击, 侵袭, 取消,结算, 打掉, 罢工,刺透, 使生根, 遇见vi. 打, 打击, 抓,罢工, 搏动, 触礁,敲, 响, 穿透, 打动
rat	n. 鼠, 卑鄙的人,破坏者, 变节者vi. 捕鼠, 变节 vt. 弄蓬松
additional	a. 附加的, 另外的, 额外的[机] 加添的, 附加的
usual	a. 平常的, 通常的
agricultural	a. 农业的[法] 农业的, 耕作的
thief	n. 小偷, 贼 [化] 取样
institution	n. 机构, 惯例, 制度[医] 机关, 机构,设施
formal	a. 正式的, 形式的, 礼仪的, 拘于礼节的, 拘谨的n. 正式的社交活动
connect	v. 连接, 联合, 联系
nice	a. 美好的, 和蔼的, 正派的, 做得好的, 精密的, 细微的, 挑剔的, 谨慎的
thank	n. 谢意, 感谢 vt. 谢谢, 感谢
hungry	a. 饥饿的, 荒年的, 渴望的, 不毛的[化] 欠鞣皮
permanent	a. 永久的, 不变的, 固定的, 持久的n. 烫发[计] 永久的
humanity	n. 人性, 人类, 博爱
winter	n. 冬季, 萧条期,衰退期a. 冬天的vt. 使度过冬天vi. 过冬
frequency	n. 频率, 频数 [计] 频率
part-time	a. 兼任的, 半工半读的, 部分时间的 adv. 部分时间, 兼任地
investigate	v. 调查, 审查
character	n. 个性, 字符, 人物, 性质, 品格, 资格[计] 字符
moral	n. 道德, 品行, 寓意a. 道德的, 品性端正的, 精神上的
immediate	a. 立即的, 直接的, 接近的[医] 直接的, 立即的
throw	vt. 投, 掷, 抛,发射, 摔下, 匆匆穿上(或脱下), 抛弃, 摆脱vi. 丢, 掷, 抛n. 投掷, 掷骰子,冒险
six	num. 六, 六个
comment	n. 注解, 批评, 评论, 备注vi. 评论, 注解[计] 备注
scene	n. 场, 情景, 镜头, 发生地点, 道具, 布景, 景色[化] 现场
moon	n. 月亮, 月球, 月光vi. 闲荡 vt. 虚度
widespread	a. 充分伸展的, 广布的, 普及的, 流传广的
manner	n. 样子, 礼貌, 风格[法] 方式, 方法,样式
effectively	adv. 有效地, 有力地, 实际上
relation	n. 关系, 联系, 叙述, 故事, 家属, 亲戚[计] 关系
bore	n. 令人讨厌的人,激浪, 枪膛, 孔 vt. 使烦扰, 钻孔vi. 钻孔 bear的过去式[计] 内径; 孔径
register	n. 寄存器, 记录,登记簿, 注册vt. 记录, 注册, 提示, 表达, 把...挂号vi. 登记, 注册,挂号[计] 寄存器
civilization	n. 文明, 教化[法] 文明, 文化,文明国家的总称
tire	n. 轮胎, 头饰 vt. 使疲倦, 使厌烦, 打扮vi. 疲劳, 厌倦
clothe	vt. 给...穿衣, 盖上, 赋予
administrative	a. 管理的, 行政的 [法] 行政的, 管理的, 遗产管理的
ordinary	a. 平常的, 普通的, 平凡的n. 平常的人(或事)
mostly	adv. 大概, 大部分, 主要[经] 大部份
decorate	v. 装饰
conclude	vt. 结束, 作结论,推断vi. 结束, 推断
mid	a. 中间的, 中央的, 中部的 prep. 在...之中
impose	vt. 征(税), 把...强加于, 以...欺骗vi. 利用, 欺骗,施加影响
roll	n. 卷, 滚动, 名单, 案卷, 压路机vi. 滚, 滚动, 飘流, 起伏, 卷, 绕 vt. 使滚动, 卷,绕
wallet	n. 皮夹[法] 皮包, 皮夹,钱袋
maybe	adv. 也许, 大概n. 可能性
wealthy	a. 富有的, 丰裕的, 充分的
mile	n. 英里, 很大距离 [机] 英里, 哩
somewhat	n. 某物, 几分 adv. 多少, 几分
count	vt. 计算, 视为vi. 计数n. 计算, 合计, 计数, 伯爵[计] 计数
station	n. 车站, 站, 局,驻地, 位置, 身分,地位vt. 安置, 配置,驻扎[计] 站
connection	n. 连接, 关系, 前后关系[计] 连接
criticize	v. 批评, 吹毛求疵, 非难
fit	n. 适宜, 合身, 发作, 痉挛a. 适宜的, 对的,准备好的vt. 适合, 安装,使合身, 使适应,使合格vi. 适合, 符合,合身[计] 非特
aware	a. 知道的, 有觉悟的
insist	v. 坚持, 坚决主张, 强调
reader	n. 读者, 读物, 文选, 校对人, 讲师 [计] 阅读程序; 阅读器
host	n. 主人, 旅馆老板, 节目主持人 vt. 当主人招待,作...节目主持人[计] 主机, 宿主机
immigrant	n. 移民a. 移入的, 移民的
assistant	n. 助手, 助理, 助教a. 有帮助的, 辅助的, 助理的
request	n. 请求, 需要, 申请书vt. 请求, 要求,邀请[计] 请求
review	n. 检讨, 复习, 回顾, 检阅, 评论 vt. 温习, 检讨, 评论, 再检察, 复审vi. 复习功课, 写评论
harvest	n. 收获, 成果, 收获物, 收获期v. 收割, 收获
normal	n. 常态, 标准, 正常, 普通a. 正常的, 正规的, 标准的, 师范的, 正态的[计] 标准, 普通
distance	n. 距离, 远方, 遥远[计] 位距
dislike	n. 嫌恶vt. 讨厌, 不喜欢
whereas	conj. 然而, 鉴于 [法] 考虑到, 鉴于, 就...而论
literature	n. 文学, 文艺, 著作[经] 广告, 商品介绍等文学
extraordinary	a. 非常的, 特别的, 非凡的[经] 非常的, 特别的, 临时的
costly	a. 昂贵的, 奢华的, 费用大的
emphasis	n. 强调, 加强, 重点, 强语气
circumstance	n. 环境, 状况, 事件
guideline	n. 指导路线, 方针, 指标[经] 指导路线, 方针, 准则
minor	n. 未成年人, 副修科目a. 较小的, 二流的, 未成年的vi. 副修[计] 次要
series	n. 串联, 序列, 连续, 系列, 丛书, 套, 级数, 组[计] 系列
truth	n. 事实, 实情[法] 真实, 真相,事实
master	n. 主人, 硕士, 大师, 母机a. 主人的, 主要的 vt. 征服, 控制,精通
authority	n. 权力, 当权者,当局, 权威, 专家 [经] 代理权, 授权, 权威
session	n. 期间, 开庭期,会议, 学期[计] 会话, 对话,会晤, 通用任务程序
ill	n. 疾病, 坏事, 罪恶, 灾难a. 生病的, 邪恶的, 不吉利的, 敌意的, 不良的, 不顺利的adv. 有害地, 不幸地, 几乎不
agreement	n. 同意, 合约, 协议[经] 契约, 协议,协定
lay	vt. 放置, 产, 铺设, 布置, 提出,平息vi. 下蛋, 打赌n. 位置, 层, 隐藏处a. 世俗的, 外行的 lie的过去式
instant	n. 立即, 瞬间a. 紧急的, 立即的, 即时的
coffee	n. 咖啡, 咖啡色[医] 咖啡, 咖啡豆
useful	a. 有用的, 有益的 [机] 有用的, 有效的
fly	n. 苍蝇, 两翼昆虫, 飞行vi. 飞, 飞翔, 飘扬, 逃走vt. 飞, 飞越, 使飘扬, 逃出a. 敏捷的
red	a. 红的, 红色的,红肿的, 流血的n. 红色, 红颜料,赤字[计] 简化, 减少
discipline	n. 训练, 纪律 vt. 训练, 惩罚
employ	n. 雇用vt. 雇用, 使用,使从事于
distraction	n. 娱乐, 分心的事物, 分心[医] 注意力分散,内脱位, 牙弓过宽
final	n. 期末考试, 结局, 决赛a. 最后的, 终极的, 决定性的
container	n. 容器, 集装箱[化] 集装箱; 贮存箱; 容器(任何一 种)
slightly	adv. 些微地, 苗条地
independent	n. 独立自主者, 无党派者a. 独立的, 有主见的, 不须依赖的, 不受约束的
welcome	n. 欢迎, 欢迎词a. 受欢迎的, 可随意的, 可喜的vt. 欢迎, 接待 interj. 欢迎
spot	n. 污点, 地点, 斑点, 点, 娱乐场所,处境, 少量a. 当场的, 现场的, 现货买卖的,现金交易的, 抽样的vt. 点缀, 玷污,认出, 准确定...的位, 用灯光照射vi. 玷污
discuss	vt. 讨论, 论述 [医] 讨论, 辩论
transition	n. 转变, 转换, 变迁, 过渡时期, 临时转调[化] 跃迁
solid	n. 固体a. 坚硬的, 稳固的, 固体的, 实心的, 纯质的, 立体的, 立方的[计] 原色
borrow	vt. 借, 借入, 借用vi. 借[计] 借位; 借位数
laundry	n. 洗衣店, 洗好的衣服, 洗涤[机] 洗衣作, 洗衣店, 洗衣房
contribution	n. 捐助, 捐助之物, 贡献[经] 贡献, 捐款,补助品
regulate	vt. 管理, 控制,调节, 调整, 校准 [经] 控制, 管理
comfort	n. 舒适, 安慰, 安慰者vt. 安慰
soft	a. 软的, 温和的,柔和的, 柔滑的,温柔的, 软弱的,坡度小的, 笨的,纸币的n. 柔软的东西, 笨人, 纸币adv. 柔软地, 温和地
locate	vt. 找出, 设于,位于vi. 定居
crucial	a. 决定性的, 重要的, 严厉的[医] 十字形的; 决断的, 定局的
status	n. 状态, 情形, 地位, 要人身份[计] 状态
secret	n. 秘密, 机密, 秘诀, 秘方a. 秘密的, 极机密的, 隐蔽的, 暗中的, 神秘的, 偏僻的
depth	n. 深度, 深处, 深奥[计] 深度
lab	n. 实验室, 研究室 [医] 凝乳酶
otherwise	adv. 否则, 不同地, 别的方式
profit	n. 利润, 赢利, 利益vi. 有益, 获利,赚钱vt. 有益于
mention	n. 提到, 言及, 陈述vt. 提到, 提及
entirely	adv. 完全, 全然,一概
discussion	n. 讨论
summer	n. 夏季, 全盛时期vi. 避暑, 过夏天 [计] 加法器
motivation	n. 动机, 刺激, 推动[医] 促动, 推动,诱导
speaker	n. 说话人, 讲演 者, 发言人, 喇叭,扬声器[计] 扬声器
arrive	vi. 到达, 抵达
preserve	vt. 保护, 保持,保存, 维持, 腌,禁猎vi. 加工食品, 禁猎n. 加工成的食品,禁猎地, 保护区,防护物
trick	n. 诡计, 欺诈, 谋略, 恶作剧, 习惯,决窍vt. 愚弄, 欺骗,装饰vi. 哄骗, 戏弄a. 有决窍的, 特技的, 欺诈的, 漂亮的, 靠不住的
optimistic	a. 乐观的, 乐观主义的, 乐天的
ideal	n. 理想, 典范, 观念, 思想, 最后目标a. 理想的, 完美的, 空想的, 观念的, 唯心论的
wisdom	n. 智慧, 明智行为, 学识, 名言,贤人
beauty	n. 美, 美人
relevant	a. 有关联的, 有关系的, 适当的, 相应的[法] 有关的, 相关的
psychologist	n. 心理学家[医] 心理学家
developer	n. 开发者[计] 显影器
passenger	n. 乘客, 旅客[经] 乘客, 旅客
intense	a. 非常的, 强烈的, 紧张的, 热情的[医] 强的
fortune	n. 财富, 运气, 兴隆, 大量财产, 好运, 命运[法] 命运, 财产,大量财产
everybody	pron. 每个人, 人人
invent	vt. 发明, 创作,虚构[机] 发明
fair	n. 展览会, 市集,美好的事物a. 公平的, 按规则进行的, 不好不坏的, 晴朗的, 美丽的adv. 公平地, 正面地, 有教养地, 清楚地vi. 转晴
offering	n. 提供, 奉献物,牲礼, 上市的股票 (或证券等)[经] 出售物
statistic	n. 统计量a. 统计的, 统计学的
location	n. 位置, 场所, 特定区域[计] 位置
poll	n. 投票, 民意测验, 选举投票, 投票数, 一组人中的一个, 头颈和后脑部, 鹦鹉vt. 对...进行民意测验, 获得...票,剪树枝, 轮询vi. 投票a. 剪过毛的, 修过枝的[计]
imply	vt. 暗示, 意味 [计] 隐含
busy	a. 忙碌的, 热闹的, 没空的vt. 使忙vi. 忙碌[计] 忙; 忙碌
generous	a. 慷慨的, 有雅量的, 大量的, 丰富的
observe	vt. 觉察到, 遵守,注意到, 庆祝vi. 注意, 评论
secure	a. 无虑的, 安心的, 安全的, 可靠的, 保险的vt. 固定, 获得,保证, 使安全, 掩护, 招致vi. 停止操作, 船抛锚
magic	n. 魔术, 魔法a. 魔术的, 有魔力的, 不可思议的
automatic	n. 自动手枪, 自动机械a. 自动的, 机械的, 必然的, 无意识的
typical	a. 典型的, 象征性的[医] 典型的
sudden	n. 突然, 忽然a. 突然的, 意外的, 快速的
economics	n. 经济学[经] 经济学
association	n. 协会[计] 关联
bottom	n. 底部a. 底部的vt. 给...装底, 查明真相vi. 到达底部, 建立基础
engine	n. 引擎, 发动机,机车vt. 安装发动机于
eager	a. 热心的, 渴望的, 热望的
actual	a. 真实的, 实际的, 现行的[医] 实际死亡率
unlike	a. 不像的, 不同的 prep. 不像, 和...不同
impossible	a. 不可能的, 难以置信的, 令人无法忍受的
sustain	vt. 承受, 支持,供养, 继续, 忍受,蒙受, 证实, 准许 [电] 持续
meeting	n. 会议, 会面[法] 会议, 会谈,集会
abandon	vt. 放弃, 抛弃,遗弃, 使屈从, 沉溺, 放纵n. 放任, 无拘束,狂热
yes	adv. 是n. 是, 同意v. 同意
ice	n. 冰, 冰淇淋, 糖衣, 冷若冰霜, 矜持, 贿赂vt. 使结冰, 冰镇,覆以糖衣vi. 结冰
tension	n. 紧张, 不安, 拉紧, 张力, 压力, 电压vt. 拉紧, 使紧张
adjust	vt. 调整, 使适应于, 校准vi. 适应于, 被调节, 相互熟悉而适应
peak	n. 山峰, 巅, 山顶, 顶点, 尖峰,帽舌a. 最高的, 最大值的vi. 到达最高点,消瘦, 变憔悴, 逐渐缩小vt. 使竖起, 使达到最高点
rarely	adv. 很少地, 罕有地
bias	n. 偏见, 斜纹a. 偏斜的 adv. 偏斜 vt. 使有偏见[计] 偏流; 偏压;偏磁; 偏离
saving	n. 存款, 挽救, 节约a. 搭救的, 节约的, 保留的, 补偿的prep. 除...之外
tile	n. 砖瓦, 瓷砖, 瓦片vt. 铺以瓦, 铺以瓷砖[计] 平铺
long-term	a. 长期的[经] 长期, (通常指一年以上)
cultivate	vt. 培养, 耕作
manufacturer	n. 制造业者, 厂商 [经] 制造人, 制造商, 制造厂
spirit	n. 精神, 心灵, 灵魂, 态度, 志气, 人格, 情绪, 心情,烈酒vt. 诱拐, 鼓励,鼓舞
lend	vt. 借, 贷款给,增添, 提供, 出租vi. 贷款
image	n. 影像, 肖像, 想象, 图像, 形象, 翻版vt. 作...的像, 反映, 想象, 象征n. 图像[计] 图象
girlfriend	n. 女朋友
method	n. 方法, 办法, 条理, 秩序[医] [方]法
indicator	n. 指示器, 指示剂, 指标[计] 指示器
dolphin	n. 海豚
operation	n. 操作, 动作, 手术, 运算, 作用, 业务[计] 运算
furniture	n. 家具, 帆具
speech	n. 演讲, 说话, 谈话, 言语, 引语, 民族语言[医] 言语, 语言
wheat	n. 小麦
moreover	adv. 而且, 此外
trust	n. 信任, 信赖, 相信, 受托, 职责, 信心, 托拉斯a. 信托的, 托拉斯的vt. 信赖, 信任,相信, 盼望, 赊卖给vi. 相信, 信赖,依靠[计] 委托, 信任
delight	n. 高兴, 愉快 vt. 使高兴, 乐于vi. 感到高兴(或愉快、快乐)
description	n. 描述, 说明, 种类[经] 说明书(物品), 品名种类, 货物名称
dog	n. 狗, 坏蛋 vt. 跟踪, 尾随
thought	n. 想法, 思想, 思维, 关心, 挂念 think的过去式和过去分词
partly	adv. 部分地, 在一定程度上
burger	n. 汉堡包（等于 hamburger）
genetic	a. 创始的, 遗传的, 起源的, 遗传学的[医] 生殖的, 遗传的
lunch	n. 午餐
dance	n. 跳舞, 舞蹈, 舞会v. 跳舞
attribute	n. 属性, 标志, 定语vt. 把...归于, 认为...属于[计] 属性
notice	n. 注意, 布告, 通知, 预告, 短评 vt. 注意, 通知, 评论, 提及, 关注vi. 注意
found	vt. 建立, 创立,铸造find的过去式和过去分词
anxiety	n. 焦虑, 忧虑, 令人焦虑的事[医] 焦虑
universal	a. 全世界的, 普遍的, 宇宙的, 通用的n. 一般概念
forest	n. 森林, 林区 vt. 植树于
foundation	n. 基础, 根据, 建立[化] 地基
characterize	vt. 描绘...的特性, 刻划...的性格
objective	n. 目的, 目标, 宗旨, 宾格, 实物a. 客观的, 如实的, 无偏见的, 宾格的
fiction	n. 小说, 虚构故事 [法] 虚构的事实,捏造, 拟制
sail	n. 帆, 篷, 帆船,航程, 帆状物vi. 航行, 启航,张帆而行vt. 航行于, 驾船
restriction	n. 限制, 限定, 约束[计] 限定
estate	n. 不动产, (人生的)阶段, 阶层, 财产[经] 房地产, 遗产, 财产
winner	n. 胜利者, 优胜者 [法] 取胜者
farmer	n. 农夫, 农场主 [法] 农民, 农场主, 承包者
tree	n. 树, 木料, 树状物vt. 把...赶上树  [计] 树; DOS外部命令:显示指定磁盘驱动器的目录结构
mill	n. 压榨机, 磨坊,制造厂vt. 碾磨, 磨细,搅拌, 使乱转vi. 乱转, 被碾磨
complex	n. 综合体, 情结,络合物a. 复杂的, 组合的
apart	adv. 成零碎, 成距离, 分别地, 分离着a. 分离的
broad	a. 宽广的, 辽阔的, 广大的, 显著的adv. 宽阔地n. 宽阔部分
combination	n. 组合, 合并, 联合[计] 组合图
facilitate	vt. 使容易, 促进,帮助[法] 使容易, 使便利, 推进
tough	n. 恶棍a. 强硬的, 艰苦的, 坚固的, 坚韧的, 粗暴的, 咬不动的
secretary	n. 秘书, 书记, 大臣[经] 秘书
eliminate	vt. 除去, 排除,剔除, 消除
commitment	n. 委托, 交押, 承担义务, 赞助[医] 院禁
movement	n. 运动, 动作, 运转, 移动, 倾向, 变化, 活动, 乐章 [医] 运动
guarantee	n. 担保, 抵押品,保证书vt. 保证, 担保
grant	n. 授予, 授予物,允许vt. 允许, 承认,授与[计] 授权命令
lock	n. 锁, 刹车, 水闸, 一缕头发vt. 锁, 锁上, 拘禁, 隐藏, (用锁等)拴住, 刹住vi. 锁住, (齿轮等)啮合, (船)过闸
switch	n. 开关, 电闸, 转换, 软枝, 鞭子, 道岔vt. 转变, 切换,摆动, 转换, 使转轨vi. 转换, 变换,摆动[计] 交换机；开关; 翻转; 转移
massive	a. 大而重的, 宽大的, 宏伟的[医] 大块的, 整块的, 大量的
innovative	a. 革新的, 创新的, 富有革新精神的
collapse	n. 崩溃, 倒塌, 虚脱vi. 倒塌, 崩溃,瓦解vt. 使倒塌, 折叠 [计] 折叠
toy	n. 玩具, 小玩艺儿, 小型的东西,消遣a. 供玩耍的, 作为玩具的vi. 玩弄, 戏弄,调情
demonstrate	vt. 示范, 证明vi. 示威
transform	vt. 使转换, 改变,改造, 使...变形vi. 改变, 转化,变换[计] 变换
mislead	vt. 误导
rapidly	adv. 飞快地, 迅速地, 赶紧地
knock	n. 敲, 敲打, 敲门v. 敲击, 互撞, 攻击
nearby	a. 附近的, 近旁的 adv. 在附近, 近旁地prep. 在...附近
payment	n. 付款, 支付的款项(或实物), 偿还,报应, 惩罚[经] 支付, 缴纳,支付款额
corporate	a. 社团的, 合伙的, 公司的[经] 团体的, 法人的, 社团的
number	n. 数, 数字, 数目, 号码vt. 数, 计算, 共计vi. 计算, 报数 [计] 数字
touch	n. 触觉, 碰, 触,机灵, 轻触, 格调,少许, 缺点, 弹力 vt. 接触, 触摸, 触及, 使接触, 达到, 涉及, 影响到,使轻度受害, 感动vi. 触摸, 接近,涉及, 提到
everyday	a. 每天的, 日常的, 平常的
programme	n. 节目, 节目单,程序, 纲要, 大纲,计划vt. 规划, 拟...计划vi. 安排节目, 编程序
employment	n. 雇用, 职业, 工作[经] 职业, 雇用,职工招请
website	n. 网站（全球资讯网的主机站）
dominate	v. 支配, 占优势
settle	n. 有背长椅vt. 决定, 整理, 安放, 使定居, 使平静, 支付, 安排,解决, 结算vi. 停留, 下陷, 沉淀, 澄清, 安下心来, 结清, 定居,安家
expression	n. 表达, 表现, 词语, 措辞[计] 表达式
fund	n. 基金, 资金, 存款, 财源, 贮藏 vt. 提供资金, 积累
producer	n. 生产者, 制作者, 制作人[化] 发生器; (炉煤气)发生炉; 制气炉; 生产者
mathematics	n. 数学[机] 数学
technical	a. 技术上的, 专门的, 工业的, 严格根据法律的[化] 技巧
undergraduate	n. 大学本科生, 大学肄业生a. 大学生的
symptom	n. 症状, 征候, 征兆[医] 症状
relax	vi. 放松, 松懈,松弛, 变从容, 休息, 休养vt. 使松弛, 缓和,使松懈, 使休息
sophisticate	n. 久经世故的人,精于...之道的人 vt. 篡改, 曲解, 使变得世故, 掺合,弄复杂vi. 诡辩
corporation	n. 公司, 合作, 法人团体[法] 法人团体, 社团, 法人
taxi	n. 出租车vi. 乘出租车 vt. 用出租车送
abroad	adv. 往国外, 到室外, 到处a. 往国外的, 在室外的, 广泛四散的
platform	n. 站台, 月台, 讲台, 论坛, 平台[计] 平台
smoker	n. 吸烟者, 吸烟的人, 吸烟车厢,(美)(非正式)蒸汽火车头
precisely	adv. 精确地, 明确地, 刻板地, 拘泥地, 正好, 恰恰, 对, 正是如此, 确实如此, 不错
penalty	n. 处罚, 刑罚, 罚款, 罚球, 报应, 不利结果, 妨碍[经] 罚金(款), 违约金
mail	n. 邮件, 邮政, 邮递, 盔甲vt. 邮寄, 给...穿盔甲[计] 邮件
sharply	adv. 锐利地, 严厉地, 厉害地[经] 剧烈地
bridge	n. 桥, 舰桥, 桥梁, 桥牌vt. 架桥于, 跨越 [计] 桥, 网桥, 桥接器
philosophy	n. 哲学, 人生观,哲学思想, 哲理,基本原理, 见解,达观, 沉着
magazine	n. 杂志, 仓库, 弹盒, 胶卷盒[计] 卡片箱, 介质装卸程序
select	a. 挑选出来的, 极好的v. 选择, 挑选n. 被挑选者, 精萃 [计] 选定
recover	vt. 重新获得, 恢复, 复原, 拯救vi. 痊愈, 复原,胜诉[计] 恢复
cure	n. 治疗, 治愈, 治疗法vt. 治疗, 治愈,改正, 腌制, 加工处理, 使硫化vi. 受治疗, 被加工处理, 被硫化
efficient	a. 有效率的, 能干的
officer	n. 军官, 主管, 官员, 公务员vt. 指挥
attractive	a. 吸引人的, 有魅力的[法] 有吸引力的,有迷惑力的
repeat	n. 重复, 反复 vt. 重做, 重复,复述, 使再现, 复制vi. 重复 [计] 重复
flow	n. 流程, 流动, 流量, 洋溢, 泛滥, 涨潮vi. 流动, 流泄,畅流, 川流不息,飘扬, 涌出vt. 使流动, 淹没,流出
round	n. 圆, 圆形物, 巡回, 循环, 一轮, 一回合, 一局, 范围, 轮唱a. 圆的, 球形的,丰满的, 肥胖的, 完全的, 大概的, 完美的, 圆润的 prep. 围着, 附近,绕过, 在.
so-called	a. 所谓的, 号称的 [法] 所谓的, 据称的
wed	vt. 与...结婚, 使结合vi. 结婚
aside	n. 小声说的话, 旁白adv. 在一边, 离开, 另外
interference	n. 冲突, 干涉 [计] 干扰
graffiti	n. 墙上乱写乱画的东西
adventure	n. 冒险, 冒险经历v. 冒险
photography	n. 摄影, 摄影术 [化] 照相术
surely	adv. 的确地, 安全地[经] 保证, 保证人, 保证金
submit	vt. 使服从, 使受到, 委托, 提交,认为vi. 屈服, 服从
unemployed	a. 失业的, 未被利用的[经] 没有被雇用的, 失业的, 没有被利用的
radical	n. 激进分子, 词根, 基础, 根式,根a. 激进的, 根本的, 基本的, 根的
nutrition	n. 营养, 营养学[医] 营养, 营养品
sufficient	a. 充分的, 足够的 [法] 充分的, 足够的
profession	n. 职业, 表白, 声明[化] 工种; 职业
urgent	a. 紧急的, 急迫的, 催逼的[经] 紧急的, 急迫的
commonly	adv. 一般, 普通,通常
grandparent	n. 祖父母
philosopher	n. 哲学家, 哲人,思想开创人, 达观的人[法] 哲学家, 哲学研究者
symbol	n. 符号, 象征, 代号, 信条[计] 符号; 码元
via	prep. 经由, 经过,通过[医] 病毒灭活剂
regardless	a. 不管, 不注意,不顾
celebrate	v. 庆祝, 祝贺, 举行
psychology	n. 心理学, 心理状态[医] 心理学
artificial	a. 人造的, 假的,非原地产的[医] 人工的, 人造的, 伟牟
player	n. 竞赛者, 上场队员, 游戏者, 演员 [经] 交易者
entertain	vt. 娱乐, 招待,怀抱vi. 款待
construction	n. 建筑, 构造, 建筑物[化] 施工
plunge	n. 钻进, 跳进, 跳水, 跳水池, 猛跌,落下, 投入, 开始从事, 盲目投资vi. 投入, 投身于,跳进, 陷入, 下降 vt. 使投入, 使插入, 使陷入, 使遭受
independently	adv. 独立地, 自立地
inexpensive	a. 便宜的, 不贵重的
fruit	n. 水果, 果类, 结果[医] 果实, 种实
roughly	adv. 概略地, 粗糙地, 粗暴地
concentrate	n. 浓缩, 精选v. 集中, 专心
tie	n. 带子, 线, 鞋 带, 领带, 领结, 关系, 束缚, 平局,不分胜负vt. 系, 打结, 扎,约束, 与...成平局vi. 结合, 打结,不分胜负
giant	n. 巨人, 大力士,巨大怪物a. 庞大的, 巨大的
aquifer	[化] 含水层
shopper	n. 购物者[经] 顾客, 购物的人
scale	n. 刻度, 衡量, 比例, 比例尺, 数值范围, 等级, 规模,天平, 秤, 鳞, 积垢vt. 依比例决定, 攀登, 测量, 绘制,刮鳞, 使生垢, 过秤vi. 剥落, 生水垢,重量为,
dangerous	a. 危险的[法] 危险的, 危害的
involvement	n. 卷入, 牵连, 包含, 困窘[经] 财政困难, 经济上的困窘
consult	vi. 商讨, 商量,协商, 会诊vt. 向...请教, 查阅, 考虑
fancy	n. 想象力, 幻想,喜好a. 想象的, 精美的, 新奇的, 奇特的, 高价的, 特级的vt. 想象, 设想,相信, 喜爱vi. 想象, 幻想
privacy	n. 隐私, 隐居, 秘密[计] 个人保密权
norm	n. 基准, 模范, 标准, 准则, 平均数 [化] 定额
tone	n. 音调, 音质, 语调, 语气, 色调, 气氛, 状况, 思想状态vt. 给...定色调,增强, 使...的声调和谐, 定音调vi. 颜色调和 [计] 双音频
specialist	n. 专门医师, 专家a. 专业的, 专家的
analysis	n. 分析[计] 分析机; 分析员; 分析; 分析程序
finally	adv. 最后, 终于
neon	n. 氖[化] 氖Ne
well-known	a. 众所周知的, 有名的
persistent	a. 固执的, 坚持的, 持续的, 作用持久的[法] 坚持的, 固执的, 持续的
meanwhile	n. 其时, 其间 adv. 同时, 于此时
hide	n. 兽皮, 迹象, 躲藏处vt. 藏, 隐瞒, 遮避, 剥...的皮, 隐藏vi. 躲藏 [计] 隐藏
enjoyable	a. 可从中得到乐趣的, 令人愉快的
superior	n. 长者, 占优势的人, 上级a. 上级的, 出众的, 高傲的
opinion	n. 意见, 评价, 主张[经] 意见
anywhere	adv. 无论何处
fourth	num. 第四, 四分之一
disappear	vi. 消失, 不见
marketplace	n. 市场
unfortunately	adv. 恐怕, 不幸的是
article	n. 文章, 冠词, 物品, 物件, 条款, 契约[计] 信件
flawless	a. 无瑕疵的, 无缺点的[化] 无裂纹的; 无裂缝的
urge	n. 冲动, 推动力,迫切的要求vt. 驱策, 力劝,竭力主张, 推动vi. 强烈要求
span	n. 指距, 全长, 跨距, 一段时间, 小范围vt. 以手指测量,跨越, 架设, 持续
unhealthy	a. 不健康的
birth	n. 出生, 起源[医] 生产, 分娩
junior	n. 年少者, 地位较低者, 大学三年级学生a. 年少的, 下级的, 后进的
represent	vt. 表现, 表示,描绘, 讲述, 代表,象征, 回忆, 再赠送, 再上演vi. 提出异议
guy	n. 家伙, 支索 vt. 用支索撑住,取笑, 嘲弄vi. 逃跑
recommend	vt. 推荐, 介绍,劝告, 使受欢迎,托付[经] 建议, 推荐
assume	vt. 假定, 承担,呈现vi. 装腔作势, 僭越
awareness	n. 意识, 认识[计] 识别, 议定,明白
journey	n. 旅程, 旅行, 行程vi. 旅行 vt. 游历
era	n. 时代, 纪元, 时期
conclusion	n. 结论, 结尾, 推论[法] 缔结, 结论,推论
strengthen	vt. 加强, 变坚固vi. 变强, 股票上涨
teamwork	n. 协同作业, 协力 [法] 联合工作, 联合行动, 协调工作
perfection	n. 完美, 完成, 极端[经] 完整性
spiritual	a. 精神上的, 神圣的, 崇高的, 高尚的, 鬼的, 招魂术的n. 有关教会的事
genuine	a. 真正的, 真实的, 诚恳的[医] 真性的
inflation	n. 胀大, 夸张, 通货膨胀[化] 充气吹胀; 膨胀
eight	num. 八, 八个
border	n. 边缘, 边境, 边界, 花坛vt. 在...上镶边,接近vi. 接界, 近似[计] 边框
remarkable	a. 不平常的, 值得注意的, 显著的
mom	n. 妈妈
profound	a. 极深的, 深厚的, 深刻的, 渊博的
seven	num. 七, 七个
precious	a. 宝贵的, 珍贵的, 过于精致的,珍爱的
install	vt. 安装, 安置,使就职[计] 安装, 安装程序; DOS内部命令:安装常驻程序
pull	vt. 拉, 拖, 拔,牵, 撕开, 吸引vi. 拉, 拖, 拔,有吸引力n. 拉, 拖, 拔, 拉力, 牵引力, 划船,吸引
painful	a. 痛苦的, 困难的, 令人烦恼的 [医] 疼痛的
helpless	a. 无助的, 无能为力的, 无依无靠的
immune	a. 免疫的, 免除的, 不受影响的n. 免疫者
capable	a. 有能力的, 能的, 能干的
respondent	a. 回答的, 应答的, 反射的n. 应答者, 被告
sensitive	a. 敏感的, 易感的, 灵敏的, 感光的[机] 敏感的, 灵敏的, 感度高的
exhibit	n. 显示, 显现, 展览品, 陈列品, 展览vt. 展现, 陈列,展览vi. 开展览会
desert	n. 沙漠, 应得的赏罚, 功劳a. 沙漠的, 不毛的 vt. 放弃, 遗弃, 擅离vi. 逃掉
cough	n. 咳嗽vi. 咳嗽 vt. 咳出
meat	n. 肉, 餐, 食物 [经] 肉类
successfully	adv. 成功, 结果良好, 有成就
threaten	vt. 恐吓, 威胁,预示...的凶兆vi. 威胁, 恫吓,可能来临
expectancy	n. 期待, 期望的事物, 嘱望, 希望, 期望, 预期[医] 预期
membership	n. 会员的资格, 全体会员, 会员数目 [法] 会员资格, 成员资格, 会籍
dramatic	a. 戏剧性的, 生动的
tea	n. 茶, 茶叶[医] 茶, 茶剂, 浸剂
color	n. 颜色, 面色, 颜料, 外貌vt. 把...涂上颜色, 粉饰, 使脸红,歪曲vi. 变色
grocery	n. 食品杂货店, 食品杂货业
accumulate	v. 积聚, 堆积
scare	n. 惊吓, 恐慌 vt. 惊吓, 使恐慌vi. 受惊
pilot	n. 飞行员, 领航 员, 航船者, 导向器, 驾驶仪, 向导,领导人vt. 领航, 驾驶,引导, 试用a. 引导的, 控制的, 试点的[计] 引导
bee	n. 蜜蜂, 聚会
bed	n. 床, 睡眠处, 河床, 底座, 路基, 一层vt. 提供宿处, 栽种, 安装vi. 睡, 形成坚实的一层
oppose	vt. 反对, 以...对抗, 抗争vi. 反对
sex	n. 性别, 性欲  vt. 区别...的性 别, 引起...的性欲
directly	adv. 径直地, 直接地, 直率地, 正好地, 直截了当地,(非正式)立即, 马上conj. 一...(就...), 一当...就...[计] 直接的
premium	n. 额外补贴, 奖金, 奖赏, 保险费 [医] 保险费
faculty	n. 才能, 能力, 全体教员, (大学的)系[医] 能力, [大学]院系
unlikely	a. 不太可能的
renewal	n. 更新, 革新, 复兴, 恢复, 修补, 补充, 继续, 重订,重申, 续借[经] 更新, 换新,重申
perception	n. 知觉, 感觉, 领悟力, 获取[医] 知觉
taxation	n. 课税, 征税, 抽税, 税款, 估定的税额[经] 征税, 纳税,税制
replacement	n. 归还, 更换, 代替者[医] 复位, 置换
perceive	v. 感觉; 认识, 理解; 察觉到, 意识到, 注意到
irregular	n. 不规则物, 不合规格之物a. 不规则的, 不整齐的, 不合法的
injure	vt. 伤害, 损害,使受冤屈[医] 损伤
burglary	n. 夜盗行为, 盗窃, 盗窃行为[法] 夜盗行为, 夜间入屋窃盗罪, 窃盗
slip	n. 滑, 滑行, 事故, 溜, 差错, 滑台, 下降, 插条,后裔, 板条, 瘦长的年轻人vi. 滑动, 滑倒, 失足, 溜走, 滑落,犯错, 变坏vt. 使滑动, 滑过,摆脱, 闪开,
strive	vi. 努力, 奋斗,斗争
sibling	n. 兄弟, 同胞[医] 同胞(兄弟姐妹)
shrink	n. 收缩, 萎缩, 回避vi. 收缩, 退缩,萎缩, 缩小, 回避 vt. 使收缩, 使缩小
extent	n. 范围, 程度, 区域[计] 范围
socialize	vt. 使社会化, 使社会主义化, 使适合社会需要vi. (美)(非正式)参加社交活动, 发生社交往来
recovery	n. 恢复, 复原, 痊愈, 重获[计] 恢复
ice-cream	a. 冰淇淋的, 乳白色的
unless	conj. 除非 prep. 除...之外
discovery	n. 发现, 被发现的事物[法] 要求告知, 发现, 发觉
absorption	n. 吸收, 专心, 全神贯注[化] 吸收; 吸收作用
copy	n. 副本, 摹仿, 一册v. 复印, 抄袭, 复制[计] 副本; 复制; DOS内部命令:复制文件将几个文件合并成一个文件, 以及将文件传至外设或在设备之间传送
dry	a. 干的, 无酒的,枯燥无味的, 干燥的vt. 把...弄干vi. 变干n. 干, 干涸
unwilling	a. 不愿意的, 勉强的[法] 不愿意的, 勉强的, 不服从的
bachelor	n. 单身汉, 学士[法] 学士, 单身汉
phase	n. 时期, 局面, 方面, 位相, 相, 阶段vt. 使调整相位,使定相, 使一致,逐步执行, 实行[计] 阶段
midday	n. 正午, 中午a. 正午的
dress	n. 服装, 覆盖物vi. 穿着vt. 给...穿衣, 整理
poison	n. 毒药, 毒, 毒物, 有毒害的事物 vt. 毒害, 毒杀,使中毒vi. 放毒, 下毒
discount	n. 折扣, 贴现率 vt. 打折扣vi. 贴现
outstanding	a. 杰出的, 突出的, 未偿付的, 未决定的[经] 未解决的, 未偿付
exception	n. 例外, 除外, 异议[计] 例外; 异常
rank	n. 等级, 排, 横列, 队伍, 阶级a. 茂密丛生的, 恶臭的, 十足的, 粗俗的vt. 排列, 归类于,把...分等vi. 列为, 列队n. 秩[计] 秩
nobody	n. 小人物, 无名小卒pron. 无人, 没有人
terrible	a. 可怕的, 令人恐惧的, 极坏的
cross	n. 十字架, 十字架形物件, 交叉, 十字标, 交叉路, 磨难, 杂交a. 生气的, 交叉的, 相反的v. 交叉, 横过, 越过[计] 交叉, 十字标
expose	vt. 使暴露, 使曝光, 揭穿, 陈列[医] 暴露, 露置
grief	n. 伤心, 忧愁, 悲痛, 不幸, 灾难
target	n. 目标, 靶子, 指标vt. 对准, 订指标
advise	vt. 劝告, 给...出主意, 通知, 建议vi. 提意见, 商量
shock	n. 震动, 冲突, 震惊, 冲击, 突击, 禾束堆, 休克, 长毛狗vt. 使震动, 使休克, 使受电击, 震惊得vi. 震动, 吓人a. 蓬乱浓密的
satisfaction	n. 满足, 满意, 快事, 赔偿, 赎罪, 报仇的机会[经] 偿还, 赎回
confidence	n. 信心[电] 可靠
rational	a. 理性的, 合理的n. 有理数
define	vt. 定义, 规定,使明确[计] 定义
citizen	n. 市民, 公民[法] 公民, 国民,市民
administration	n. 行政, 管理, 政府机关[化] 给药
cheat	n. 欺骗, 作弊, 骗子v. 欺骗, 逃脱, 骗取
tissue	n. 薄的织物, 薄纱, 棉纸, 组织,一套[化] 组织
vessel	n. 船, 容器, 脉管 [医] 管, 脉管,(容)器
style	n. 风格, 时尚, 文体, 风度, 字体, 类型vt. 称呼, (根据新款式)设计, 使合潮流n. 风格, 样式[计] 风格, 样式
architect	n. 建筑师, 设计者, 缔造者
absorb	vt. 吸收, 使全神贯注, 同化, 买进,理解, 承受, 忍受,承担[医] 吸收
flexibility	n. 弹性, 适应性[计] 灵活性; 适应性
twin	n. 双胞胎中一人,一对非常相像的人 (或物)中的一个a. 双胞胎的, 成对的, 孪生的vi. 生双胞胎, 成对vt. 怀(双胞胎),使成对
coach	n. 四轮大马车, 教练vt. 训练, 指导vi. 坐马车旅行,作指导
exchange	n. 交换, (电话)交换局, 交换机, 汇兑, 交易所v. 交换, 交易, 兑换[计] 交换; 电话局
shut	n. 关闭vt. 关上, 闭起,幽禁, 合拢, 轧住vi. 关上, 停止营业
accomplishment	n. 成就, 完成
reality	n. 实在, 事实, 实体, 逼真[法] 现实, 实在存在的事物, 实在性
stability	n. 安定, 稳定性,坚实, 巩固[化] 稳定性
obvious	a. 明显的, 明白的, 显然的, 平淡无奇的
court	n. 法院, 庭院, 奉承vt. 献殷勤, 追求,招致vi. 求爱
sport	n. 运动, 游戏, 娱乐, 消遣, 玩笑a. 运动的, 户外穿戴的vi. 游戏, 参加体育运动, 戏弄, 产生变种vt. 炫耀, 使产生变种
flexible	a. 易曲的, 灵活的, 柔顺的, 能变形的, 可通融的[医] 能屈的
muscle	n. 肌肉, 臂力 [医] 肌
reliable	a. 可靠的, 可信赖的[法] 可靠的, 可信赖的, 确实的
favorite	n. 喜欢的事物, 幸运儿a. 特别受喜爱的,喜爱的, 宠爱的,中意的
load	n. 负荷, 担子, 重担, 装载量, 负载,工作量, 加载vt. 装载, 装填,使担负vi. 装货, 上客,装料[计] 加载, 装入程序
eventually	adv. 最后, 终于
length	n. 长度, 长, 期间, 一段[计] 记录长度; 块长; 字长
square	n. 正方形, 街区,广场, 平方, 直角尺a. 正方形的, 正直的, 公正的, 平方的, 方正的, 结清的adv. 成直角地, 对准地vi. 一致, 符合,结清vt. 使成方形, 使平方
mechanic	n. 机械工, 技工a. 手工的
technique	n. 技巧, 技术, 方法[化] 工艺方法; 技巧
echo	n. 回声, 回音, 回波vi. 发回声, 随声附和vt. 摹仿, 重复,反射[计] 回显; DOS批处理命令:控制MS- DOS命令是否在屏幕上显示
transport	n. 运输, 运输工具, 激动, 狂喜,流放犯vt. 传送, 运输,流放[计] 传送
teenager	n. 十三岁到十九岁的少年
estimate	n. 估计, 判断 vt. 估计, 评价,判断vi. 估计
dine	vi. 用正餐, 进餐 vt. 宴请
diploma	n. 文凭, 毕业证书 [医] 文凭
truck	n. 卡车, 货车,对...进行交易, 来往, 实物工资, (供应市场的)蔬菜, 废物, 废话vt. 对...进行交易, 交往, 以卡车运输vi. 驾驶卡车, 以物易物
sight	n. 景观, 视力, 眼界, 阅读, 见解, 意见vt. 看见, 瞄准vi. 瞄准, 观看a. 即席的, 见票即付的
ethic	n. 道德规范, 伦理
tablet	n. 平板, 门牌, 笔记簿, 碑, 匾, 药片[化] 片剂
cycle	n. 周期, 循环, 自行车, 一段时间, 整套vi. 循环, 轮转,骑自行车vt. 使循环, 使轮转[计] 环路; 周期;循环
nervous	a. 神经紧张的, 不安的, 神经的[医] 神经的; 神经质的, 神经过敏的
voice	n. 声音, 嗓音, 嗓子, 愿望, 发言权,表达, 喉舌, 语态 vt. 表达, 吐露, 调音
journal	n. 日记, 杂志, 日报[化] 轴颈
gasoline	n. 汽油[化] 汽油
injury	n. 伤害, 侮辱 [医] 伤, 损伤
trait	n. 特征, 特性, 一笔, 少许
email	n. 电子信函
supermarket	n. 超级市场[经] 超级市场, 自助售货商店
beat	n. 心跳(声), 打,敲打声, 拍子v. 打, 拍打, 打败a. 疲乏的, 颓废的 beat的过去式[计] 拍; 节拍
blue	n. 蓝色a. 蓝色的, 下流的, 忧郁的vt. 染成蓝色vi. 变蓝
compel	vt. 强迫, 迫使
discrimination	n. 差别, 岐视, 辨别力[化] 鉴别
propose	vt. 计划, 打算,建议, 提议, 求 (婚)vi. 打算, 求婚
interpret	vt. 解释, 演出,翻译, 理解vi. 翻译, 解释
hurry	n. 匆忙, 急忙, 急促vt. 急派, 催促vi. 匆忙, 赶快
vital	a. 生命的, 重要的, 充满活力的,生死攸关的, 致命的[医] 生命的, 生活的, 生活上必需的,紧要的
helpful	a. 有帮助的, 有益的, 有用的
angry	a. 生气的, 愤怒的
son	n. 儿子, 女婿, 子孙[法] 儿子, 女婿,养子
appropriate	a. 适当的[经] 适当的, 拨出, 占用
drought	n. 干旱, 缺乏
wise	a. 明智的, 慎虑的, 聪明的, 博学的, 狡猾的, 机灵的vi. 知道vt. 教导, 告诉,劝导n. 方法, 方式[计] 教育信息系统
afraid	a. 害怕的, 恐怕的, 遗憾的
sheet	n. 床单, 张, 纸张, 印刷品, 裹尸布, 薄片vt. 盖上被单, 遍布vi. 大片落下a. 片状的, 成薄片的[计] 工作表
abstract	a. 抽象的, 深奥的n. 摘要, 抽象概念 vt. 摘要, 提炼, 使抽象化[计] 摘录; 摘要;抽象
dad	n. 爸爸, 爹爹
arrange	v. 安排, 排列, 达成协议[计] 重排
dropout	n. 退学学生, 中途退学[电] 离去
compromise	n. 妥协, 折中, 折中方案, 和解vi. 妥协处理vt. 危害
edge	n. 边缘, 尖锐, 刀刃, 优势vt. 使锐利, 挤进,镶边vi. 缓缓移动
racial	a. 人种的, 种族的 [医] 种族的
constantly	adv. 不变地, 不断地, 时常地
properly	adv. 适当地, 相当地
delivery	n. 递送, 交付, 分娩, 交货, 引渡[化] 交货额
indeed	adv. 的确, 实在,真正地, 甚至
solely	adv. 仅仅, 单独地
infer	vt. 推论出, 推断vi. 作推论
unskilled	a. 无(特殊)技能的, 不熟练的, 拙劣的
theater	n. 戏院, 电影院,剧场, 全体观众,戏剧, 戏剧效果,阶梯式讲堂, 场所
initial	n. 字首, 首字母a. 开始的, 最初的, 字首的vt. 用姓名的首字母签名
self-control	n. 克己, 自制
artistic	a. 艺术的, 艺术家的, 富有艺术性的
presence	n. 出席, 面前, 存在, 仪态, 风度[电] 出现
neighbor	n. 邻居 vt. 邻接vi. 毗邻而居, 友好a. 邻近的
pose	n. 姿势, 姿态, 装模作样, 伪装vi. 摆姿势, 装模作样, 假装vt. 使摆好姿势,提出, 造成
gym	n. +体育馆, 体育训练, 体育课, 体操
circle	n. 圆周, 社交圈,循环, 范围vt. 围着, 环绕vi. 盘旋, 循环
deeply	adv. 深刻地, 在深处, 深沉地
schedule	n. 时间表, 一览表, 计划表, 议事日程vt. 预定, 编制目录, 制...表, 安排
interact	vi. 互相影响, 交互作用n. 幕间剧, 幕间休息
discourage	vt. 使气馁, 阻碍
negotiate	vi. 商议, 谈判,交涉vt. 谈妥, 转让,处理
crash	n. 哗啦声, 猛撞,崩溃, 粗布v. 撞碎, 破碎, (使)...坠毁a. 速成的[计] 崩溃
hybrid	n. 混血儿, 杂种,混合物a. 混合的, 杂种的, 混合语的[计] NetWare的主机实用程序, 双重用户建立程序
hot	a. 热的, 热心的,辣的, 热情的, 激动的, 猛烈的, 紧迫的adv. 热, 紧迫地
fantasy	n. 幻想, 想象的产物[医] 幻想
committee	n. 委员会[经] 委员会
victim	n. 受害人, 牺牲者, 牺牲品[法] 受害人, 被害人, 遭难者
narrow	n. 狭窄部分, 隘路a. 狭窄的, 仔细的, 有限的, 勉强的, 狭隘的, 手紧的vi. 变窄vt. 使变狭窄
sword	n. 刀, 剑, 战争,武力, 剑状物
raw	n. 擦伤处, 半成品a. 生的, 未加工的, 生疏的, 不成熟的, 阴冷的, 刺痛的, 擦掉皮的 vt. 擦伤[计] 写后读
brew	n. 酿造酒, 酝酿v. 酿造, 酝酿
chat	n. 闲谈vi. 闲谈, 聊天
barely	adv. 几乎不
page	n. 页, 记录, 事件, 专栏, 男侍 vt. 标明...的页数, 翻...的书页,分页排版, 呼叫,侍候vi. 翻书页, 侍侯[计] 页; 页面
marital	a. 丈夫的, 婚姻的, 夫妇间的[医] 婚姻的
competitor	n. 竞争者[经] 竞争者, 竞争对手
brother	n. 兄弟
intelligent	a. 聪明的, 智能的, 了解的
attempt	n. 尝试, 企图 vt. 尝试, 企图
scholar	n. 学者, 奖学金获得者, 有文化者, 学习者
highway	n. 公路, 大道, 捷径[法] 公路, 大路
outer	a. 外部的, 外面的, 在外的, 远离中心的[机] 外部的, 外面的, 外侧的
relieve	vt. 减轻, 救济,解除, 使免除,换...的班, 使得到调剂, 使不单调, 衬托, 使显著vi. 救济, 当替补投手, 呈鲜明突出
considerable	a. 相当的, 可观的, 重要的
illustrate	vt. 举例说明, 作图解, 阐明vi. 举例说明
cake	n. 蛋糕, 块, 饼 vt. 使结块, 加块状物于vi. 结块
intellectual	n. 有知识者, 知识分子, 凭理智做事者a. 智力的, 用脑力的, 聪明的
drill	n. 钻孔机, 钻子,播种机, 粗斜纹布v. 训练, 钻孔
intervention	n. 插入, 介入, 调停[经] 干预
inequality	n. 不平等, 不同,不平坦, 不平均n. 不平等, 不等式[计] 不等式
overtake	vt. 赶上, 突然降临于, 压倒, 代替
prevail	vi. 获胜, 流行,盛行[医] 流行, 盛行
preference	n. 偏爱, 优先, 喜爱物[计] 首选项
stone	n. 石头, 宝石, 果核, 纪念碑, 结石 vt. 投扔石子, 铺石头a. 石的, 石制的,完全的
patience	n. 耐性, 忍耐
amuse	vt. 消遣, 娱乐,使发笑
wood	n. 木材, 木制品 vt. 植林于, 给...添加木柴vi. 收集木材
cool	n. 凉爽, 凉爽的空气a. 凉爽的, 冷淡的, 冷静的vi. 冷却, 平息 vt. 使冷却, 使平静
apologize	vi. 道歉, 辩解
statement	n. 陈述, 指令, 声明[计] 程序语句; 语句
sadness	n. 悲哀, 悲伤
deadly	a. 致命的, 致死的 adv. 非常, 如死一般地
fireplace	n. 壁炉
bakery	n. 面包店
unnecessary	a. 不必要的
steer	vt. 引导, 驾驶,航行, 控制vi. 驾驶, 掌舵,行驶n. 驾驶指示, 劝告
temporary	a. 暂时的, 临时的n. 临时工, 临时雇员[计] 临时
procedure	n. 程序, 过程, 手续[计] 规程; 过程
contemporary	n. 同时代的人a. 同时代的, 属于同一时期的
luxury	n. 奢侈, 豪华a. 奢侈的, 豪华的
unemployment	n. 失业, 失业人数 [经] 失业
gallery	n. 走廊, 最高楼座, 画廊, 收集,图库[计] 图库
strain	n. 紧张, 拉紧, 张力, 过劳, 扭伤, 血缘, 种, 族, 气质, 曲调, 旋律, 口吻vt. 使劳累, 拉紧,过分使用, 扭伤, 滥用, 曲解, 滤vi. 尽力, 努力,紧拉, 弯曲,
overwhelm	vt. 淹没, 受打击,制服, 压倒, 使不知所措[法] 打翻, 倾覆,覆盖
blank	n. 空格, 空白a. 空白的, 空虚的, 完全的, 无色的vi. 消失, 成为空白vt. 使无效, 取消,封锁[计] 空白
charm	n. 吸引力, 魔力,符咒vt. 迷住, 使陶醉,行魔法vi. 用符咒, 有魅力
numerous	a. 很多的, 数目众多的, 多数的[机] 多数的, 甚多的
stock	n. 树干, 祖先, 血统, 原料, 备料, 库存, 牲畜, 股票,股份, 保留剧目a. 存货的, 常备的, 平凡的, 普通的, 股票的, 保留剧目的, 繁殖用的 vt. 装把手于, 进货, 备有
factory	n. 工厂, 产生地,代理店[经] 工厂, 代理店, 商行在国外的代理处
ineffective	a. 无效的[法] 失效的, 无效的, 效率低的
therapy	n. 治疗[医] 疗法, 治疗
occasion	n. 场合, 时机, 机会, 诱因, 理由 vt. 惹起, 引起
fish	n. 鱼, 鱼肉, 鱼类, 接合板vt. 钓, 钓鱼, 查出, 用接合板连接vi. 捕鱼, 钓鱼,用钩捞取, 摸索寻找
routine	n. 常规, 日常工作, 惯例, 例行公事a. 日常的, 常规的 [计] 例程
flower	n. 花, 开花植物,精华, 盛时vi. 开花, 发育,旺盛, 成熟vt. 用花装饰, 使开花
realistic	a. 现实的, 逼真的, 现实主义的,实在论的
computerize	vt. 用电脑处理,使电脑化[经] 给...装备电脑, 用电脑计算
peaceful	a. 平静的, 和平的, 和平时期的,爱好和平的, 喜爱安静的[法] 和平的, 爱好和平的, 和平时期的
tour	n. 旅游, 观光旅行, 任期vi. 旅行, 周游,巡回vt. 周游, 观光,游历, 使巡回演出
cup	n. 杯子, 茶杯, 优胜杯vt. 使成杯状,为...拔火罐
dig	vt. 挖, 翻土, 发掘vi. 挖掘n. 挖掘[计] 数字, 数位
arrest	n. 逮捕, 监禁 vt. 拘捕, 抑制,吸引, 阻止
identity	n. 身份, 相同, 一致, 特性, 恒等式 [计] (打)标记, 标识
ambitious	a. 有野心的, 抱负不凡的, 雄心勃勃的
sharp	n. 半升音调, 利刃, 骗子a. 锋利的, 明显的, 敏锐的, 急剧的, 尖刻的, 严厉的, 刺耳的, 精明的adv. 锐利地, 急速地
rival	n. 对手, 竞争者a. 竞争的
origin	n. 起源, 起因, 出身, 开端[计] 原点; 起始地址; 信件来源的相关数据
potato	n. 马铃薯
pie	n. 馅饼, 财富, 总额, 贪污受贿, 杂乱, 喜鹊[计] 饼图
confident	a. 有信心的, 有把握的
basis	n. 基础, 主要成分 [化] 基底
tackle	n. 工具, 复滑车,滑车, 装备, 扭倒 vt. 固定, 处理,抓住vi. 扭倒
candidate	n. 候选人, 投考者 [法] 候选, 候补者
cart	n. 二轮运货马车vi. 驾运货马车 vt. 用车装载
recycle	vt. 使再循环, 重新利用, 再制n. 再循环
dirty	a. 肮脏的, 卑鄙的 vt. 弄脏vi. 变脏
fellow	n. 男人, 朋友, 同事a. 同伴的, 同事的, 同道的
behave	vi. 举止端正, 行为规矩vt. 检点(自己的)行为, 使表现好
editor	n. 编者, 编辑, 主笔, 编辑器, 编辑装置[计] 编辑器
excuse	vt. 原谅, 申辩,做为...的托辞n. 致歉, 理由, 饶恕, 借口
hair	n. 头发, 毛发, 些微[医] 毛, 发
export	n. 输出品, 输出 vt. 输出, 出口vi. 输出物资 [计] 导出
quote	n. 引用vt. 引述, 举证,报(价)vi. 引用
region	n. 区域, 地带, 地区, 领域, 范围, 区[计] 区, 区域
ongoing	a. 前进的, 进行的, 不间断的n. 前进, 发展
displace	vt. 移置, 替换,转移
religious	a. 宗教性的, 虔诚的, 宗教上的, 严谨的n. 修道士, 出家人
tendency	n. 趋向, 倾向[医] 趋向, 趋势
asleep	a. 睡着的, 长眠的, 麻木的adv. 熟睡地
designer	n. 设计者, 谋划者, 制图者[计] 设计员
glass	n. 玻璃, 玻璃杯,透镜vt. 装玻璃于, 反射, 反映vi. 成玻璃状
abruptly	adv. 突然地, 唐突地
observer	n. 观察者, 遵守者, 观察员[法] 观察者, 观察员, 监场员
evolution	n. 进化, 发展, 进展, (气体)放出, 开方[医] 进化, 演化,旋出
reform	n. 改革, 改正, 改造vt. 改革, 改过,革新, 重整vi. 革新, 改过
fascinate	vt. 令人入神, 使着迷vi. 入迷
deed	n. 行为, 实行, 契约vt. 立契转让
undergo	vt. 遭受, 经历,忍受[法] 经受, 经历,忍受
visual	a. 视觉的[医] 视觉的, 视力的, 视觉性记忆优势者
bus	n. 公共汽车[计] 总线; 汇流条; 母线
lion	n. 狮子, 狮子(星)座, 国际狮子会会员
technician	n. 技师[化] 技师
inspire	vt. 使感动, 激发,启示, 吸入, 鼓舞,产生, 使生灵感vi. 吸入, 赋予灵感
disruptive	a. 分裂的, 破坏 (性)的[计] 击穿的, 中断的
appreciate	vt. 赏识, 鉴别,为...而感激, 领会, 欣赏vi. 增值, 涨价
strict	a. 严厉的, 绝对的, 详尽的, 严格的, 精确的[法] 严格的, 精确的, 绝对的
insight	n. 察看, 洞察力,见识[医] 自知力, 洞察, 顿悟
middle-class	a. 中层社会的, 中产阶级的
museum	n. 博物馆
insurance	n. 保险, 保险业,保险费[医] 保险
quarter	n. 四分之一, 一刻钟, 季度, 地区 vt. 四等分, 肢解vi. 驻扎, 住宿
multiple	n. 倍数, 并联a. 多样的, 许多的, 多功能的
etc	及其他, 等等
ownership	n. 所有权, 物主身份[经] 所有权, 所有制
identical	a. 同一的, 恒等的, 完全相同的[医] 同一的, 同等的
appearance	n. 出现, 露面, 外观, 外表, 出版[计] 外观, 版面
extreme	n. 极端, 末端a. 极端的, 尽头的, 极度的, 偏激的
devote	vt. 投入于, 献身
freshwater	a. 江河湖泊的, 淡水的
pride	n. 骄傲, 自尊心,自豪, 精华, 勇气 vt. 以...自豪
inadequate	a. 不充分的, 不适当的[法] 不充分的, 不适当的
runway	n. 跑道, 河床, 过道[化] 单轨架空道;吊车道
normally	adv. 正规地, 合规则, 正常地
assumption	n. 假定, 自负, 担任, 假装[经] 假定, 承担
physically	adv. 按自然规律,完全地, 实际上,真正地, 身体上地
arm	n. 手臂, 袖子, 狭长港湾, 武器vt. 武装, 装备vi. 武装起来[计] ARM 处理器；异步应答方式; 自动货品销路管理
operate	v. 操作, 运转, 动手术, 活动
wheel	n. 轮子, 车轮,  轮, 方向盘, 旋转,机构, 重要人物vt. 使旋转, 转动,使转向vi. 旋转, 转弯,盘旋
active	a. 活跃的, 起作用的, 积极的, 有效的, 主动的, 活性的, 现行的, 现役的n. 主动语态, 积极分子
grand	a. 庄重的, 壮观的, 显赫的, 重大的, 最高的, 雄伟的, 宏大的, 豪华的, 傲慢的[法] 重大的, 主要的, 伟大的
ethical	a. 伦理的, 民族的, 民族特有的[医] 伦理的, 道德的
outlet	n. 出口, 发泄方法, 市场[医] 出口
invention	n. 发明, 创作能力, 虚构的故事 [经] 发明
countless	a. 数不尽的, 无数的
conference	n. 会议[经] 会议, 讨论会, 协商会
prey	n. 被掠食者, 牺牲者vi. 捕食
medication	n. 药物治疗, 药物处理, 医药[医] 药疗法, 投药法
perspective	n. 远景, 透视感, (观察问题的)视角,透视法, 看法, 透视图a. 透视的, 透视法的[计] 透视
noise	n. 噪音, 杂音, 响声, 喧闹vt. 谣传vi. 喧闹 [计] 噪声
requirement	n. 需求, 必要条件, 要求[化] 要求; 合同要求
afternoon	n. 午后, 下午
naturally	adv. 自然地, 以自然力, 天生地
independence	n. 独立, 自立, 自主[医] 自主性, 独立性
lucky	a. 幸运的, 吉祥的, 好运的, 侥幸的
energetic	a. 精力充沛的, 积极的
dessert	n. 餐后甜点
romantic	a. 浪漫的, 风流的, 传奇性的, 夸大的, 空想的, 浪漫派的
race	n. 种族, 人种, 赛跑, 比赛, 急流, 人类, 同道, 姜根vi. 赛跑, 竞赛,疾走vt. 与...赛跑, 使疾走, 使猛转[计] 竞争; 追赶;欧州高级通信研究开发计划
wonderful	a. 令人惊奇的, 奇妙的, 极好的
council	n. 会议, 委员会 [经] 委员会
earnings	n. 所赚的钱, 工资, 收入[经] 工资, 收入,收益, 盈余
golden	a. 金的, 含金的,金色的, 贵重的,繁盛的[法] 金制的, 金色的, 兴隆的
quiet	n. 安静, 闲适, 平静a. 安静的, 静止的, 寂静的, 朴素的, 从容的, 暗中的vi. 平静下来vt. 使平静, 使平息, 使安心, 安慰
attraction	n. 吸引, 吸引人的事物, 吸引力[医] 吸引
shoulder	n. 肩, 肩膀, 衣肩 vt. 肩负, 负担, 担任vi. 用肩推挤
crack	n. 裂缝, 爆裂声v. (使)爆裂, (使)裂开, (使)发出爆裂声a. 第一流的adv. 啪地一声
duty	n. 责任, 关税, 职务, 尊敬[化] 职责
genius	n. 天才, 天赋, 精神, 神魔[医] 特征
except	vt. 除, 除外vi. 反对prep. 除了...之外, 若不是, 除非 conj. 只是
division	n. 分, 分开, 除法, 部门(如部、处、系等), 师[计] 部分
interfere	vi. 妨碍, 冲突,干涉, 抵触[医] 干扰, 干涉,阻碍, 碰腿(马)
thick	a. 厚的, 粗壮的,浓的, 迟钝的, 浑浊的, 多雾的, 过分的, 口齿不清的 adv. 厚地, 密地,浓浓地n. 最浓处, 最厚处, 最密集处[计] 暗, 粗线
wealth	n. 财富, 资源, 财产, 丰富, 富裕, 大量[经] 财富
root	n. 根, 根本, 根源, 基础, 底部 vt. 使扎根, 使固定, 根除, 肃清,搜出, 用鼻拱vi. 生根, 固定,源于, 用鼻拱土,寻找, 捧场, 支持
core	n. 核心, 果心, 要点vt. 挖...的核[计] 内核, 核心网
heritage	n. 遗产, 祖先遗留物, 继承物[医] 遗传性
analyze	vt. 分析, 细察,分解[机] 分析
stable	n. 马房, 牛棚a. 稳定的, 安定的, 坚固的, 坚定的vt. 赶入马房vi. 被关在马厩
explanation	n. 解释, 说明, 辩解, 表明[经] 解释, 注释,说明
atmosphere	n. 大气, 空气, 气氛[医] 大气; 大气压
affordable	[计] 普及型
recruit	n. 新兵, 新手, 新会员, 补给品vt. 恢复, 补充,充实, 征募vi. 征募新兵, 复原, 得到补充
upset	a. 弄翻的, 混乱的, 心烦的vt. 弄翻, 颠覆,推翻, 打乱, 使不适, 使心烦vi. 翻倒
distract	vt. 转移, 分心,使发狂
burn	vt. 烧, 烧毁, 烧伤vi. 燃烧, 发热,烧毁n. 烧伤, 烙印
defense	n. 防卫, 防卫物 [医] 防御
specialize	vt. 使特殊化, 列举, 特别指明, 限定...的范围vi. 成为专家, 专攻
margin	n. 页边的空白, 边缘, 界限, 余裕, 差数, 差额, 保证金vt. 加边于, 加旁注于[计] 页边距
favor	n. 好意, 喜爱 vt. 赐予, 支持,喜欢, 证实
architecture	n. 建筑学, 建筑式样[计] 体系结构
resort	n. 度假胜地, 手段, 凭借, 常去之地vi. 诉诸, 常去
onto	prep. 在...之上
hat	n. 帽子vt. 给...戴帽子
shout	n. 呼喊, 喊声vi. 呼喊, 喊叫,嚷vt. 高喊
chemistry	n. 化学, 化学过程 [化] 化学
resolve	vi. 决定, 分解,决心vt. 使分解, 解析,解决, 消除, 决心n. 决定之事, 决心, 坚决
cue	n. 提示, 线索 vt. 给...暗示(或提示)[计] 尾接指令
practitioner	n. 从业者, 开业者 [医] 行医者, 医师
confirm	vt. 证实, 确定,批准, 使巩固[计] 确认
shelter	n. 庇护所, 避难 所, 庇护, 隐蔽处,掩蔽vt. 庇护, 保护,隐匿vi. 躲避
bright	a. 明亮的, 聪明的, 鲜明的, 欢快的adv. 明亮地, 欢快地
bake	vt. 烘焙, 烤vi. 烤面包n. 烘焙, 烤
supervise	v. 监督, 管理, 指导
constitute	vt. 构成, 组成,任命[建] 构造, 组成
anyway	adv. 无论如何, 至少
faulty	a. 有过失的, 有缺点的, 不完美的, 应受责备的[经] 缺点多的
infrastructure	n. 基础结构, 基础设施[经] 基础设施
fare	n. 费用, 旅客, 食物vi. 进展, 进步,经营, 过活
dispute	n. 争论v. 争论
cite	vt. 引用, 引证,表彰[建] 引证, 指引
breakfast	n. 早餐
transmit	vt. 传输, 传染,传达, 遗传, 发射,传播vi. 发射信号, 留传下来[计] 传送
pollutant	n. 污染物质 [法] 污染物
accessible	a. 易接近的, 可进入的, 可使用的, 易受影响的, 可理解的
accommodate	vt. 使适应, 调和,通融, 容纳, 向...提供vi. 适应
govern	v. 统治, 支配, 管理
reaction	n. 反应, 反作用,反动[医] 反应
license	n. 执照, 许可证,特许vt. 许可, 特许
opponent	n. 对手, 敌手, 反对者a. 敌对的, 反对的, 对面的
forum	n. 论坛, 公开讨论的广场, 法庭, 讨论会[法] 讨论会, 专题讨论, 公共论坛
hall	n. 门厅, 走廊, 会堂
capture	n. 抓取, 战利品,捕获之物vt. 抓取, 获得,迷住[计] 截获命令
definitely	adv. 明确无疑地,清楚地
possibly	adv. 可能, 也许
breed	n. 种类, 品种v. 养育, 引起, 饲养, 繁殖
classical	a. 古典的, 正统派的, 经典的[医] 古典的; 标准的, 典型的
initially	adv. 最初, 开头
praise	n. 赞美, 称赞, 崇拜vt. 称赞, 赞美vi. 赞扬, 表扬
ride	n. 骑马, 乘坐, 乘车, 搭便车vt. 骑, 乘坐, 压迫, 控制vi. 骑马, 乘车,漂游
pale	n. 栅栏, 界线, 范围a. 苍白的, 暗淡的, 无力的vi. 变苍白, 变暗,失色vt. 使变苍白, 使失色, 用栅栏围
mission	n. 任务, 代表团,使命, 传教团vt. 派遣, 向...传教
exploit	n. 功绩, 勋绩 vt. 开发, 利用,开拓, 剥削
violence	n. 猛烈, 暴力, 暴虐, 暴行[法] 暴行, 暴力,暴乱
electric	a. 电的, 导电的,电动的[医] 电的
fault	n. 过错, 故障, 毛病vt. 挑剔vi. 产生断层, 弄错[计] 故障
terrify	vt. 使恐惧, 恐吓
leap	n. 跳跃, 剧增, 急变, 被越过之物vi. 跳跃, 突然经过vt. 跃过, 使跃过
overweight	n. 超过重量, 过重, 优势a. 超过重量的, 超重的vt. 使超重, 重于,过于重视
fine	n. 罚款, 罚金, 晴天, 精细a. 好的, 晴朗的,健康的, 细小的,精细的vt. 罚款, 精炼,澄清vi. 变清, 变细 adv. 很好[计] 精细
version	n. 一种描述, 版本, 译文[计] 版本
disaster	n. 灾祸, 不幸, 彻底失败
confront	vt. 使面对, 对抗,遭遇, 使对质, 比较[法] 对证, 使对质, 比较
underground	n. 地下, 地铁, 地道, 秘密活动a. 地下的, 秘密的 adv. 在地下, 秘密地
direct	a. 直接的, 坦白的 vt. 指示, 指挥, 命令, 导演vi. 指导, 指挥 adv. 直接地
literary	a. 文学的, 文艺的, 精通文学的[法] 文学的, 从事文学的, 从事写作的
unit	n. 单位, 分队, 部队, 单元, 部件, 装置a. 单位的, 单元的 [计] 单元常数; 部件
dozen	n. 打, 十二个a. 一打的
graduation	n. 毕业, 得学位,分划, 刻度, 分等级[医] 刻度, 分度,毕业
substantial	n. 重要材料(或事物), 有实际价值的东西a. 实质上的, 物质的, 有内容的, 结实的
doubtful	a. 可疑的, 疑心的, 不明确的[法] 怀疑的, 有疑问的, 未确的
log	n. 记录, 圆木, 日志, 计程仪vt. 伐木, 切, 航行vi. 伐木[计] 日志
victory	n. 胜利, 战胜, 克服
prescribe	v. 规定, 指定, 嘱咐, 开处方
garden	n. 花园, 果园, 菜园vi. 栽培花木 vt. 造园a. 花园的, 普通的
cinema	n. 电影院, 电影
bind	vt. 绑, 约束, 装订, 包扎, 使结合vi. 凝固, 有约束力[计] 赋值, 绑定
principal	n. 校长, 首长, 本金, 主犯, 资本, 委托人a. 主要的, 最重要的, 首要的
gloomy	a. 抑沉的, 忧闷的, 黑暗的, 悲观的
plus	prep. 加上, 加,外加a. 正的, 附加的n. 正号, 加号, 附加额, 正数, 增益 [计] 正差
somebody	n. 了不起的人, 大人物pron. 有人, 某人
grasp	n. 把握, 抓紧, 理解, 抓, 柄, 控制 vt. 抓住, 紧握, 领会vi. 抓
density	n. 密度[化] 密度
whale	n. 鲸vi. 捕鲸vt. 使惨败, 猛揍
killer	n. (非正式)杀人 者, 屠杀者, 猛兽,致死(疾病), 杀手,止痛药, 限制器, 瞄准器[计] 删除程序; 断路器
theme	n. 主题, 话题, 题目
retail	n. 零售a. 零售的vt. 零售, 详述,传播vi. 零售
strongly	adv. 强有力地, 坚强地, 激烈地
hemisphere	n. 半球, 地球的半面, 大脑半球[医] 半球
sixth	num. 第六, 六分之一
net	n. 网, 网状物, 罗网, 净利, 净价a. 净的, 最终的 vt. 用网捕, 撒网,净赚, 得到vi. 编网[计] 网络, 网络分析程序
file	n. 档案, 公文箱,文件夹, 文件, 卷宗, 锉刀vi. 列队行进, 用锉刀做vt. 归档, 申请,锉, 琢磨[计] 文件
somehow	adv. 不知何故
obviously	adv. 显而易见地,明显地
legislation	n. 立法, 法律[医] 立法, 法规
awful	a. 可怕的, 庄严的, 虔敬的
old-fashioned	a. 旧式的, 过时的, 保守的, 大人模样的
proud	a. 骄傲的, 自大的, 自豪的, 辉煌的, 壮丽的
stack	n. 堆叠, 堆, 大量, 书库, 枪架,烟囱, 堆积, 存贮栈vt. 堆积, 堆满,暗中对...做手脚vi. 堆起[计] 堆积, 堆栈
territory	n. 领土, 领地, 版图, 地区, 活动范围[经] (推销员等的)推销区域
negotiation	n. 谈判, 磋商, 交涉[经] 谈判, 协商
tiny	a. 很少的, 微小的
phenomenon	n. 现象, 迹象, 表现, 奇迹, 奇才[化] 现象
bread	n. 面包, 生计, 食物vt. 裹以面包屑
sponsor	n. 保证人, 赞助者, 发起者, 倡议者, 教父vt. 发起, 赞助,倡议
mystery	n. 秘密, 神秘, 奥秘
reluctant	a. 不情愿的, 勉强的[法] 不愿的, 勉强的, 难以处理的
clarity	n. 清楚, 明晰[化] 透明度; 透明性; 清晰性
opposition	n. 反对, 敌对, 相反, 在野党[医] 对生, 对向,反抗, 反对症
quantity	n. 量, 数量, 总量 [计] 数量; 量
suit	n. 套装, 诉讼, 请求, 起诉, 套, 组 vt. 适合, 使适应vi. 合适, 相称
boundary	n. 边界, 分界线 [计] 边界
representative	n. 代表, 众议员,典型a. 描写的, 表现的, 代理的, 代表的, 代议制的, 典型的
relief	n. 减轻, 解除, 救济, 安慰, 调剂, 浮雕, 换班, (地势的)起伏[医] 缓减, 减轻,浮雕(绘画中)
marine	n. 舰队, 水兵, 海景画a. 海的, 海产的,海底的, 船舶的,海运的
widen	vt. 弄宽, 加宽,扩大vi. 变宽, 扩大
evolutionary	a. 展开的, 进化论的, 进化的, 发展的[计] 进化的, 改良的, 发展的
setting	n. 环境, 背景, 布景, 镶嵌, 调整, 沉落, 一副餐具[计] 设置
pioneer	n. 先锋, 拓荒者,创始人vt. 提倡, 开辟,开创, 倡导vi. 作先驱, 开路a. 最早的, 开拓的, 先驱的, 有开拓者特点的
deserve	vt. 该得到, 值得vi. 应得报答
fierce	a. 凶猛的, 猛烈的, 热烈的, 暴躁的
adequate	a. 适当的, 足够的 [法] 胜任的, 适当的, 充分的
navigate	vi. 航行vt. 航行于, 驾驶,操纵, 使通过
deadline	n. 最后期限, 截止期限[经] 截止日期
passionate	a. 热情的, 热烈的, 易怒的, 热恋的
persuade	vt. 劝, 使相信,恳求, 敦促, 说服vi. 劝服, 被说服
cigarette	n. 香烟, 纸烟
ad	n. 广告[计] 地址, 模拟-数字
folk	n. 人们, 家人, 亲属, 民族a. 民间的
poverty	n. 贫穷, 贫困, 缺乏[医] 贫乏, 缺乏
nowadays	n. 现在, 现时, 当今adv. 时下, 现今
stir	n. 骚动, 轰动, 搅动, 监狱vt. 移动, 摇动,激起, 惹起, 搅拌vi. 走动, 传播,搅拌
outnumber	vt. 数目超过,比...多
weakness	n. 虚弱, 薄弱, 弱点[经] 欲振乏力
paperback	n. 平装本, 纸面本
dictate	vi. 听写, 口述,口授vt. 口述, 使听写,命令n. 命令, 指挥, 指令
ethically	adv. 伦理上
clue	n. 线索, 暗示 vt. 暗示, 提供线索
altogether	adv. 完全地, 总而言之
weekly	n. 周刊, 周报a. 每周的, 一周一次的, 周刊的adv. 每周, 一周一次
routinely	adv. 日常, 乏味,常规, 例行
rice	n. 米, 米饭, 稻 vt. 将...压成米粒状
pace	n. 速度, 步调, 步法vi. 踱步, 缓慢走 vt. 用步测, 踱步于
slowly	adv. 慢慢地, 迟缓地
tragedy	n. 悲剧, 惨案, 悲剧作品[法] 惨事, 灾难,不辛
elaborate	a. 精细的, 详尽 的, 精心计划(或制作)的vt. 详细地说明,用心地制作, 发挥vi. 变复杂, 作详细说明
tower	n. 塔, 高楼, 堡垒vi. 高耸, 翱翔
union	n. 联盟, 联合, 结合, 工会[化] 联合; 联管节; 活接头
fundamental	n. 基本原理, 原则, 基波a. 基本的, 重要的, 原音的
irrigation	n. 灌溉, 冲洗[医] 冲洗法, 灌溉
jump	n. 跳跃, 跳动, 暴涨, 惊跳vt. 跳跃, 跃过,突升, 使跳跃vi. 跳跃, 跳, 跳动, 暴涨[计] 转移, 跳转
coin	n. 硬币, 金钱, 货币vt. 铸币, 创造,杜撰
cloud	n. 云, 阴暗, 烟雾, 疑团vt. 以云遮敝, 笼罩, 使黯然vi. 乌云密布, 阴沉
civilize	vt. 使开化, 使文明vi. 变文明
uncertainty	n. 不确定, 不可靠, 不确定的事物 [化] 不确定度
imbalance	n. 不平衡, 不均衡 [医] 不平衡, 失调
reap	vt. 收割, 收获,获得vi. 收割, 得到报应
disability	n. 无力, 无能, 残疾[医] 劳动能力丧失, 病废
reproduce	v. 繁殖, 再生, 复制, 生殖[计] 复制
silver	n. 银, 银币, 银器a. 银的, 银制的,银器的vt. 镀银vi. 变银白色
fitness	n. 适合, 合宜, 合理, 恰当, 健康[医] 适合性, 适应性
stressful	a. 着重, 强调, 重读, 使受应力
intention	n. 意图, 目的, 含义[医] 愈合, 意向
disagree	vi. 不一致, 不适宜[法] 抵触, 不同意, 争执
evil	n. 邪恶, 不幸, 罪恶a. 邪恶的, 不幸的, 有害的, 讨厌的
combat	n. 争斗, 战斗vi. 战斗, 争斗 vt. 与...战斗,与...斗争
fulfill	vt. 实践, 履行,实行, 完成, 结束,满足[法] 履行, 完成,达到
initiative	n. 主动行动, 首创精神, 主动权a. 自发的, 起始的
fifth	num. 第五, 五分之一
brand	n. 商标, 牌子, 烙印vt. 打烙印于
instantly	adv. 立即地, 即刻地
fatal	a. 致命的, 重大的, 命运注定的,粗心的, 不幸的[医] 致命的, 致死的
accurate	a. 正确的, 精确的 [经] 准确的, 精确的
endanger	vt. 危及[法] 使危险, 危及
ton	n. 吨[经] 吨
newly	adv. 重新, 最近
orbit	n. 轨道, 常轨, 眼眶vt. 绕...轨道而行vi. 进入轨道, 盘旋
repeatedly	adv. 重复地, 再三地
reputation	n. 名誉, 名声, 声望[法] 名声, 名誉,公认证据
react	vi. 起反应, 起作用, 反攻[医] 应答, 发生反应
ancestor	n. 祖先, 祖宗
outdoor	a. 户外的, 屋外的, 露天的
considerably	adv. 非常地, 很,颇
standardize	vt. 使标准化, 使合于标准, 用标准检验[计] 标准化; 规格化
trigger	n. 触发器, 扳机 vt. 触发, 发射,引起vi. 松开扳柄[计] 切换开关
random	n. 随意, 随机a. 任意的, 随便的, 胡乱的, 随机的adv. 胡乱地
topic	n. 主题, 论题, 话题
vote	n. 投票, 选举, 选票, 表决, 选举权,得票数vi. 投票, 选举 vt. 投票选举, 投票决定, 公认, 使投票
intern	n. 实习生, 被拘留者vi. 作实习医师(教师、实习生)vt. 拘留, 扣留
mainstream	n. 主流
ring	n. 环, 环形物, 拳击场, 戒指, 角逐,小集团, 铃声, 钟声, 声调vt. 包围, 套住,按铃, 敲钟vi. 成环形, 响,鸣, 按铃, 敲钟,回响
cell	n. 单元, 细胞, 电池[计] 单元
brief	n. 摘要, 简报a. 简短的, 短暂的 vt. 对...作简报,摘要, 节录
swell	n. 增大, 隆起的部分, 巨浪, 肿胀a. 优秀的, 一流的vi. 增大, 膨胀,肿胀, 增强, 骄傲 vt. 使膨胀, 使增大, 使上涨, 使骄傲
restore	vt. 回复, 恢复,归还, 修补, 修复 vt. 还原vi. 还原[计] 还原; DOS外部命令:从备份盘中取回文件
upgrade	n. 上坡, 升级, 上升adv. 往上vt. 使升级, 提升,改良品种vi. 升级[计] 升级
season	n. 季节, 时节, 当令期, 时期vt. 给...调味, 使成熟, 使老练, 缓和vi. 变干燥
greet	vt. 问候, 致敬,欢迎, 映入眼帘
theft	n. 盗窃, 失窃, 盗窃罪, 赃物[法] 盗窃行为, 偷窃, 失窃
snow	n. 雪, 积雪, 下雪, 雪花形干扰vi. 下雪, 似雪般落下vt. 使雪白, 用雪覆盖, 使像雪般落下
dark	n. 黑暗, 夜, 黄昏, 模糊a. 黑暗的, 暗的,深色的, 隐密的,模糊的, 无知的
shoot	n. 射击, 狩猎,  芽, 射伤, 发射, 发芽, 急流, 推力,摄影, 急送, 滑运道, 浪费vt. 射击, 射中,损毁, 拍摄, 喷出,投射, 挥出, 飞速行进, 挥霍, 给...注射v
cooperation	n. 合作, 协力, 配合[化] 合作
industrial	a. 工业的, 供工业用的, 工业高度发展的, 产业的n. 工业工人, 工业股票
youth	n. 年轻, 青年时 代, 青年们, 青春 [法] 青年, 青年时期, 青春时期
weaken	vt. 削弱, 减弱,使虚弱vi. 变弱, 变软弱
continent	n. 大陆, 洲a. 自制的
phrase	n. 惯用语, 词组,成语, 措词, 乐句 vt. 用短语表达,把(乐曲)分成短句 [计] 短语
facial	n. 美颜, 脸部按摩a. 脸的, 表面的,脸部用的
rock	n. 岩石, 岩礁, 石头, 基石, 暗礁, 摇动, 摇滚乐vt. 摇摆, 摇动,使摇晃, 使动摇vi. 摇, 摇动
fairly	adv. 美观地, 公平地, 相当地, 清楚地
virtual	a. 实际上起作用 的, 虚的, 实质的,有效的, 事实上生效的[计] 虚拟
sample	n. 样品, 范例, 样本vt. 抽样, 尝试[计] 示例, 字样
gas	n. 气体, 汽油, 瓦斯[化] 气体; 煤气;瓦斯; 毒气
distress	n. 苦恼, 贫困, 痛苦vt. 使苦恼a. 亏本出售的
smartphone	n. 智能手机
compute	v. 计算, 估算n. 计算, 估算
uniform	n. 制服a. 统一的, 一律的, 始终如一的
existence	n. 存在, 生存[法] 存在, 存在状态, 实体
particle	n. 颗粒, 粒子, 质点, 极小量[化] 粒子; 质点
ninth	num. 第九, 九分之一
sympathy	n. 同情, 赞同, 怜悯, 慰问, 吊唁[医] 交感[作用],同感[作用], 感应,同情
emphasize	vt. 强调, 加强语气, 着重
tuition	n. 学费, 讲授
disorder	n. 杂乱, 混乱 vt. 扰乱, 使失调
terrorist	n. 恐怖分子[法] 恐怖份子, 恐怖主义
exact	a. 精确的, 准确的, 精密的vt. 强求, 急需
temptation	n. 诱惑, 诱惑物[法] 诱惑, 诱惑物
bedroom	n. 卧室
sedentary	a. 久坐的, 坐惯的, 定栖的[医] 静坐的; 坐式的
creature	n. 人, 动物, 创造物, 生物
collaborative	a. 合作的, 协作的
incline	n. 倾斜, 斜坡, 斜面vt. 使倾向于, 使倾斜vi. 倾向, 倾斜,爱好, 易于
download	[计] 卸载, 下栽
pocket	n. 口袋, 钱袋,钱, 容器vt. 装...在口袋里, 隐藏, 抑制, 私吞, 搁置, 击...入袋a. 袖珍的, 小型的, 压缩的, 金钱上的
etiquette	n. 礼仪, 礼节, 成规[法] 规则, 成规,礼节
bar	n. 条, 棒, 酒吧,栅, 障碍物vt. 禁止, 阻挡,妨碍[计] 棒形图
exceptional	a. 例外的, 异常的, 特别的
talented	a. 天资高的, 有才能的
reference	n. 参考, 索引, 参照vt. 给...加上参考资料vt. 引用vi. 引用 [计] 引用
mobility	n. 可动性, 流动性, 机动性[化] 迁移率
edit	vt. 编辑, 编校,修订, 剪辑[计] 编辑; DOS外部命令:该命令是一个用于编辑文本文件的全屏幕编辑程序
unknown	a. 不知道的, 未知的, 陌生的n. 未知物, 未知数
obstacle	n. 障碍, 妨害物,阻碍
resistance	n. 抵抗力, 反抗,耐力, 阻力, 电阻 [化] 抵抗; 抗性;阻力; 抗药性; 电阻
counter	n. 计算器, 计算者, 柜台, 筹码a. 反方向的, 相反的adv. 反方向地, 相反地[计] 计数器; 计数字
grandmother	n. 祖母, 女祖先
web	n. 网, 蛛丝, 蹼,织物, 圈套, 卷筒纸vi. 结网, 形成网 vt. 织蜘蛛网于,使落入圈套
idle	a. 懒惰的, 闲散的, 停顿的, 空闲的, 无用的vi. 无所事事, 闲散, 浪费, 空转 vt. 虚度, 使闲散,使空转n. 空转, 空闲时间[计] 空闲时间
trap	n. 圈套, 陷阱, 诡计, 存水弯vi. 设圈套, 设陷阱vt. 诱捕, 诱骗,抓住, 使受限制[计] 俘获; 陷井
soul	n. 灵魂, 心灵, 精神, 精髓, 人, 化身, 典型, 鬼魂a. 黑人的
spell	n. 符咒, 魅力, 轮值, 轮班, 工作时间, 一次发作vt. 拼写, 拼成,琢磨, 理解, 招致,轮换, 迷住vi. 轮换, 拼字
mine	n. 矿, 矿藏, 地雷 vt. 挖掘, 开采, 在...布雷, 破坏vi. 开矿, 埋设地雷pron. 我的
misunderstanding	n. 误会, 误解[法] 误解, 误会,不和
conservation	n. 保护, 保存 [医] 保存
oven	n. 烤箱, 灶, 子宫 [化] 烘箱
hormone	n. 荷尔蒙[化] 激素(旧称荷尔蒙)
justify	vt. 替...辩护, 证明vi. 证明合法[计] 段落重排, 两端对齐
ought	aux. 应该, 大概n. 责任
cruise	n. 巡航, 巡弋, 漫游v. 巡航, 巡弋, 漫游
enlarge	vt. 扩大, 增大vi. 扩大, 详述
complaint	n. 诉苦, 抱怨, 控诉[医] 陈诉; 病
poisonous	a. 有毒的, 恶毒的, 讨厌的[医] 有毒的
nutritional	a. 营养的, 滋养的 [医] 营养的
reasonable	a. 合理的, 明理的, 适当的[法] 合理的, 公道的, 正当的
lightning	n. 闪电vi. 闪电a. 闪电的
towards	prep. 向, 对于,为了
handicraft	n. 手工艺, 手艺[经] 手工业, 手工
leg	n. 腿, 假腿, 路程vi. 走, 跑
surrounding	n. 环境a. 周围的
appointment	n. 约会, 委任的职位, 委派[经] 任命, 派, 指定
visitor	n. 参观者, 游客,访客[法] 视察人, 检视人, 检查员
inability	n. 无能, 无力
naval	a. 海军的, 军舰的, 有舰队的[法] 海军的, 军舰的, 船的
lengthen	vt. 加长, 使延长vi. 变长
wave	n. 波, 波浪, 波动, 起伏, 高潮,潮涌, 挥手致意, (气压)突变vi. 波动, 飘动,挥手示意, 起伏 vt. 使波动, 使飘扬, 挥舞, 使成波浪形
horse	n. 马, 骑兵, 脚架vi. 骑马, 取笑 vt. 使骑马, 系马于
transformation	n. 变形, 变质, 变化, 改革, 变换[化] 转化; 变换
definition	n. 定义, 精确度,清晰度[计] 清晰度; 清晰度
fee	n. 费用, 小费, 封地, 所有权vt. 付费给
aggressive	a. 侵略的, 挑畔的, 进取的[法] 侵略的, 爱挑衅的, 行为过火的
volunteer	n. 志愿者a. 志愿的v. 自愿
publisher	n. 出版者, 发行人 [法] 发行人, 出版者, 报刊发行者
stroke	n. 笔划, 打, 中风, 抚, 摩, 冲程 vt. 划尾桨, 抚,摩, 划去[计] 笔划
underwater	a. 在水中的 adv. 在水下
induce	vt. 引诱, 招致,归纳出, 感应[医] 诱导, 感应
operator	n. 操作员, 行家,经纪人, 算子, 运算符[计] 运算符
steady	a. 稳定的, 不动摇的, 沉着的, 稳固的, 坚定的, 经常的vt. 使稳定, 使坚定vi. 变为沉着, 稳固
attach	vt. 附上, 使依附,使附属, 使喜爱, 系, 缚vi. 附属, 归属,联系在一起[计] 挂接服务器命令, 关联, 挂接, 附加
meter	n. 米, 公尺, 仪表, 计量器vt. 以仪表计量
truly	adv. 真实地, 不假
grind	n. 磨, 碾, 苦差,摩擦声, 用功的学生vt. 磨擦, 磨碎,磨光, 折磨, 压榨vi. 磨, 磨碎, 苦干
rigorous	a. 严厉的, 严酷的, 严格的, 苛刻的, 严密的, 精确的
luggage	n. 行李, 皮箱
contrary	a. 相反的, 矛盾的, 对立的n. 相反, 对立面adv. 相反地
apple	n. 苹果, 家伙 [医] 苹果
output	n. 输出, 产品, 产量[计] 输出
sunburn	n. 日炙, 晒斑, 晒焦, 晒黑vt.vi. (使)晒黑, (使)晒得退色,(使)晒焦
gold	n. 黄金, 钱财, 金块, 金色, 宝贵a. 金的, 似金的,金色的, 金制的
burglar	n. 窃贼[法] 夜盗, 窃贼,盗窃者
morale	n. 士气, 道德
investigation	n. 调查, 审查[医] 调查, 调查研究
indifferent	a. 漠不关心的, 无重要性的, 中立的 [医] 中性的, 无作用的, 无亲和力的,淡漠的
sociable	a. 好交际的, 社交的, 过社会生活的n. 联谊会
dancer	n. 舞蹈演员, 跳舞者
beach	n. 海滩
luxurious	a. 豪华的, 奢侈的, 放纵的
renew	vt. 使更新, 使恢复, 复兴, 修补,补充, 继续, 重订,重申, 续借vi. 更新, 重新开始
friendship	n. 友谊, 友爱, 友善
obligation	n. 义务, 责任, 约束, 契约, 恩惠, 债务[经] 待付款, 债务, 义务
smell	n. 味道, 气味, 嗅觉, 嗅, 臭味, 气息vt. 闻, 探出, 察觉, 发出...的气味vi. 嗅, 散发气味,发臭
sum	n. 总数, 总和, 金额, 概要, 顶点 vt. 总计, 概括vi. 合计[计] 系统实用程序和维护
pupil	n. 学生, 门生, 未成年人, 瞳孔[医] 瞳孔
approve	vt. 赞同, 核准,为...提供证据vi. 赞许
donation	n. 捐赠物, 捐款,捐赠[经] 赠品, 捐款,捐赠
spite	n. 恶意, 怨恨, 使人烦恼的事物vt. 故意刁难, 欺侮
text	n. 文本, 正文, 课文, 主题, 圣经文句, 乐谱[计] 电文; 文本;正文
besides	prep. 除...之外 adv. 而且, 此外
observation	n. 观察, 注意, 观测, 观察力[化] 观察
lean	n. 瘦肉, 倾斜, 倾斜度a. 瘦的, 贫乏的,歉收的vi. 倚靠, 倾斜,依赖vt. 使倾斜
rhythm	n. 旋律, 节奏, 韵律, 匀称, 张弛节律[医] 节律
fan	n. 风扇, 迷, 狂热者, 爱好者vt. 煽动, 刺激,吹拂vi. 飘动, 成扇形散开
tape	n. 带子, 录音带,磁带, 窄带, 卷尺 vt. 以带子绑起,测量, 录音[计] 带
deepen	vi. 深化vt. 使加深, 使强烈
unhappy	a. 不快乐的, 不幸的, 不适当的
integrate	vt. 综合, 使完整,使成整体vi. 成一体a. 完整的, 完全的
slave	n. 奴隶, 从动装置, 卑鄙的人vi. 拼命工作[计] 从设备
excess	n. 过度, 剩于, 超过, 超额a. 过量的, 额外的
rider	n. 骑手, (文件后的)附件, 扶手[化] 游码
diversity	n. 差异, 多样性 [化] 多样性
vision	n. 视觉, 眼光, 视力, 幻想vt. 梦见, 想象,显示
comparable	a. 可比较的, 比得上的
string	n. 线, 细绳, 一串, 字符串vt. 串起, 成串,收紧, 缚, 扎vi. 成一串[计] 字符串, 串
mechanism	n. 机械, 机构, 结构, 机理, 技巧[化] 机理; 历程;机构
boat	n. 船vi. 乘船 vt. 以船运
welfare	n. 福利, 安宁, 幸福, 福利事业a. 福利的
undertake	vt. 试图, 从事,保证, 承担, 同意,接受[化] 承包; 承担
campaign	n. 战役, 运动, 竞选运动vi. 参加运动, 作战
salary	n. 薪水vt. 给...加薪
orange	n. 柑橘, 桔子, 橘色a. 橘色的
collaboration	n. 合作, 勾结[法] 通敌卖国者,奸细
lower	a. 低的, 下级的,下层的vi. 降低, 跌落,减弱vt. 放下, 降下,减弱, 贬低
careful	a. 小心的, 谨慎的
